Language_SKYLOFTER  NAMES
Mudora,Kaepora,Madas,Eagus,Owlan,Horwell,Henya,Gully,Greba,Goselle,Gondo,Fledge,Jakamar,Karane,Keet,Kina,Luv,Orielle,Mallara,Rusta,Wryna,Strich,Pumm
[OBJECT:LANGUAGE]

[TRANSLATION:SKYLOFTER  NAMES] 
	CAD name="Malle"
	DECAY name="Mudome"
	DECEIVER name="Maedokall"
	DEEP name="Mekas"
	DEER name="Kanye"
	DEMON name="Karall"
	DESPAIR name="Oresome"
	DESTROYER name="Monyeroda"
	DESTRUCTION name="Kiedadada"
	DEVIL name="Judav"
	DEVOURER name="Earebura"
	DINE name="Gille"
	DINNER name="Raballe"
	DIRT name="Genye"
	DITCH name="Kame"
	DOG name="Ken"
	DOMESTIC name="Jonirulle"
	DONKEY name="Halle"
	DOOM name="Hasut"
	DOOR name="Hunan"
	DRAGON name="Jukeba"
	DRAIN name="Orome"
	DRAWL name="Pame"
	DREG name="Odome"
	DRESS_CLOTHING name="Ealle"
	DRESS_GENERAL name="Omalle"
	DRINKER name="Ginaera"
	DRIP name="Ogome"
	DROOL name="Morar"
	DROWNED name="Madallut"
	DRUM name="Larar"
	DRY name="Kume"
	DUMP name="Meme"
	DUMPLING name="Earodge"
	DUNG name="Hora"
	DUNGEON name="Strepall"
	DUSK name="Gorer"
	DUST name="Grune"
	DUTY name="Para"
	DYE name="Ger"
	EAGLE name="Junye"
	EAR name="Rar"
	EAST name="Hallo"
	EAT name="Eara"
	ECTO name="Pare"
	EEL name="Gut"
	EERIE name="Hurome"
	EGG name="Mas"
	ELDER name="Larune"
	ENTRAILS name="Howlepune"
	ETERNAL name="Hararav"
	EVER name="Gagav"
	EVERLASTING name="Flarebowlav"
	EVERSEEING name="Roguwlav"
	EVIL name="Orara"
	EXECUTE name="Henyada"
	EXECUTIONER name="Flarebullulla"
	EYE name="Kus"
	FACE name="Harwa"
	FALL name="Lalla"
	FALSE name="Mella"
	FAMINE name="Raresut"
	FANG name="Hanye"
	FAT name="Kieme"
	FATAL name="Rogut"
	FATHER name="Ganepo"
	FEAR name="Grame"
	FEAST name="Konat"
	FETID name="Ganyut"
	FIEND name="Gall"
	FIERCE name="Korada"
	FILTH name="Howla"
	FIN name="Gunye"
	FIND name="Gura"
	FINGER name="Maranus"
	FIRE name="Kera"
	FIRST name="Karora"
	FISH_ANIMAL name="Kinye"
	FISH_VERB name="Rurut"
	FIST name="Koda"
	FLAME name="Parera"
	FLANK name="Kewles"
	FLEA name="Game"
	FLESH name="Flakav"
	FLING name="Lolle"
	FLOOD name="Lame"
	FLOWER name="Hadonye"
	FLUTE name="Kiriev"
	FLY_ANIMAL name="Orall"
	FLY_VERB name="Kura"
	FOCUS name="Orunya"
	FOG name="Konye"
	FOOL name="Keeme"
	FOOT name="Orure"
	FOREST name="Jugekor"
	FORK name="Meeme"
	FORTIFY name="Leerorwa"
	FORTRESS name="Peneginya"
	FRAGILE name="Kemaduda"
	FRAGMENT name="Easteeme"
	FRAME name="Kuran"
	FRAY name="Rome"
	FREE name="Gara"
	FRENZY name="Osech"
	FREEZE name="Kandome"
	FRILL name="Flat"
	FROG name="Henye"
	FRUIT name="Oranye"
	FUNGUS name="Kokeme"
	FUR name="Kar"
	GALL name="Holla"
	GAME name="Julle"
	GARISH name="Jollura"
	GARLIC name="Earaden"
	GARNISH name="Earudgan"
	GATE name="Oran"
	GAUNT name="Omome"
	GAZE name="Muras"
	GEAR name="Huren"
	GERBIL name="Gudulle"
	GHOST name="Heras"
	GHOUL name="Kerut"
	GIFT name="Lane"
	GILL name="Gagut"
	GIRDLE name="Hurolla"
	GLAND name="Howlur"
	GLAZE name="Konape"
	GLEN name="Onon"
	GLIDE name="Onaga"
	GLIMMER name="Kapolla"
	GLISTEN name="Husaegas"
	GLOSS name="Osella"
	GLOVE name="Onarwa"
	GLUTTON name="Kerudome"
	GOAT name="Hulle"
	GOD name="Jewle"
	GOD-FORSAKEN name="Haballorerall"
	GOLD name="Flura"
	GOOSE name="Osulle"
	GORE name="Kirar"
	GORGE_NOUN name="Eadade"
	GORGE_VERB name="Earepe"
	GRAIN name="Golle"
	GRAND name="Kadall"
	GRAPE name="Orolle"
	GRASS name="Renye"
	GRAVE name="Granut"
	GREASE name="Lunyet"
	GREAT name="Karos"
	GREED name="Hapome"
	GREEN name="Oller"
	GRIFFON name="Likawlav"
	GRILL name="Gelle"
	GRIM name="Gaeme"
	GRIND name="Kiella"
	GRIP name="Reda"
	GRISTLE name="Howlunda"
	GRIZZLE name="Komech"
	GROVE name="Onorav"
	GROW name="Rolle"
	GROWL name="Gonye"
	GROWTH name="Laepas"
	GRUB name="Kunye"
	GUARD name="Garwa"
	GUILE name="Haneme"
	GUISE name="Herere"
	GUT name="Peda"
	GUTTER name="Kimas"
	HAG name="Girev"
	HAIR name="Gude"
	HAIRY name="Gerar"
	HAME name="Kaene"
	HAMMER name="Hukire"
	HAMMERER name="Goderella"
	HAND name="Kanya"
	HANDY name="Lodama"
	HARE name="Relle"
	HARVEST name="Flerulle"
	HARVEST_VERB name="Earalluv"
	HATCHET name="Jeseda"
	HATE name="Madga"
	HAUNT name="Heruna"
	HAWK name="Lanye"
	HAY name="Olle"
	HEAD name="Mora"
	HEART name="Radada"
	HEARTH name="Kedille"
	HEATHER name="Onadara"
	HEDGE name="Heelle"
	HELL name="Kall"
	HELM name="Earwa"
	HERO name="Karot"
	HEX name="Papas"
	HIDE name="Garar"
	HIDEOUS name="Howlunye"
	HIGH name="Kare"
	HILL name="Ogur"
	HIP name="Jolle"
	HOARY name="Minar"
	HOBBLE name="Kewlape"
	HOG name="Ronye"
	HOLY name="Kowle"
	HOIST name="Ganasa"
	HOLE name="Herus"
	HOME name="Polle"
	HONEY name="Earano"
	HOOD name="Obiet"
	HOOF name="Monye"
	HOP_NOUN name="Lulle"
	HOP_VERB name="Kur"
	HORN name="Huda"
	HORSE name="Odelle"
	HOUND name="Odulle"
	HOWL name="Jenye"
	HUG name="Jamm"
	HUM name="Kelle"
	HUNGER name="Kogome"
	HUSTLE name="Gudgome"
	ICE name="Gach"
	IDLE name="Ogame"
	IDOL name="Karun"
	ILL name="Gome"
	IMPURE name="Gandume"
	INCENSE name="Kanyolla"
	INCH name="Eare"
	INK name="Mer"
	INN name="Haba"
	INSANITY name="Hururunda"
	INVISIBLE name="Herunyorase"
	IRON name="Eadat"
	ITCH name="Horwa"
	IVY name="Kane"
	JACK name="Hech"
	JACKAL name="Magunye"
	JAUNDICE name="Kakarome"
	JAW name="Hinye"
	JEST name="Molle"
	JOKE name="Pille"
	JUGGLE name="Kunalle"
	JUICE name="Hodat"
	JUNGLE name="Ogonye"
	JUST name="Lara"
	JUSTIFY name="Gendach"
	KEEPER name="Godarwa"
	KEG name="Hura"
	KEY name="Jura"
	KINDNESS name="Runorwev"
	KILLER name="Gubada"
	KISS name="Ramm"
	KING name="Monus"
	KNEAD name="Grelle"
	KNIFE name="Rakada"
	KNIGHT name="Raera"
	KNIT name="Molla"
	KNOT name="Herut"
	LACE name="Malla"
	LAKE name="Hodga"
	LARD name="Horav"
	LARK name="Ranye"
	LARVA name="Obanye"
	LAST name="Onane"
	LAW name="Lerwa"
	LAZY name="Grome"
	LEADER name="Karanev"
	LEAF name="Eanye"
	LEAK name="Rame"
	LEAN name="Kally"
	LEECH name="Hollan"
	LEGEND name="Karuner"
	LENS name="Jenya"
	LEOPARD name="Oruranye"
	LEPER name="Modime"
	LEPROSY name="Rureme"
	LETTER name="Resonya"
	LIE name="Okall"
	LIGHT name="Husen"
	LIGHTNING name="Lielluwlur"
	LIMB name="Hana"
	LIP name="Kille"
	LISTEN name="Mudanya"
	LIZARD name="Menanye"
	LOBSTER name="Magedut"
	LOCK name="Kona"
	LONE name="Heres"
	LONG name="Hasta"
	LOOT name="Lome"
	LORD name="Kamer"
	LOST name="Herar"
	LOUSE name="Horosa"
	LOVE name="Gerev"
	LOW name="Kewle"
	LUNCH name="Flelle"
	LUNG name="Oroda"
	LURID name="Horupa"
	LURCH name="Earome"
	LURK name="Mume"
	LUSH name="Runye"
	LUST name="Gech"
	LUTE name="Lulla"
	LYRIC name="Pilla"
	MAGGOT name="Horesan"
	MAGIC name="Flirwa"
	MAN name="Gar"
	MANGE name="Oranya"
	MANY name="Rone"
	MARSH name="Flome"
	MARTYR name="Haenut"
	MASTER name="Karodin"
	MAW name="Oda"
	MEAD name="Rille"
	MEADOW name="Onastov"
	MEAL_DOM name="Haste"
	MEAL_GROUND name="Kella"
	MEAT name="Hopar"
	MEDITATION name="Onuridgenene"
	MELLOW name="Onurur"
	MENACE name="Kodinda"
	MESS name="Hume"
	METAL name="Hudav"
	MIDNIGHT name="Leebenall"
	MIGHTY name="Ganyera"
	MIGHTINESS name="Kandusagapa"
	MILE name="Kaga"
	MINCE name="Marada"
	MIND name="Ganya"
	MINION name="Karuna"
	MIRROR name="Hemalle"
	MISERY name="Flogume"
	MIST name="Hera"
	MITE name="Hodov"
	MOLD name="Minye"
	MOLE name="Herat"
	MOLTEN name="Okarara"
	MONKEY name="Ollanye"
	MOON name="Ostes"
	MONGER name="Manalle"
	MOTH name="Hene"
	MOTHER name="Ganawlo"
	MOUSE name="Kerir"
	MOUTH name="Earan"
	MUCK name="Honya"
	MUD name="Ome"
	MUFFIN name="Kusalle"
	MULE name="Jalle"
	MUNCH name="Eapada"
	MURDER name="Rerut"
	MUSH name="Gere"
	MUSHROOM name="Earurenus"
	MUSIC name="Kidgiv"
	MYSTERY name="Herilla"
	MYTH name="Grav"
	NAIL name="Fleda"
	NASTY name="Manome"
	NATURE name="Jekanye"
	NECRO name="Pamut"
	NEGATIVE name="Jarameme"
	NEGATE name="Kisame"
	NEO name="Hepas"
	NEST name="Ragav"
	NESTLE name="Ogaelle"
	NET name="Midun"
	NETTLE name="Maranye"
	NEW name="Lukas"
	NEWT name="Golly"
	NIBBLE name="Kemara"
	NIGHT name="Ragov"
	NIGHTMARE name="Huregerall"
	NOBLE name="Karamm"
	NOOSE name="Meda"
	NORTH name="Haruch"
	NOSE name="Haeba"
	NULL name="Jella"
	NUMBER name="Genanya"
	NURTURE name="Gumelle"
	NUT name="Onye"
	OAK name="Flune"
	OAR name="Kemut"
	OAT name="Earer"
	OBLIVION name="Flarobav"
	OCEAN name="Kunyut"
	OLD name="Eane"
	OMEN name="Renav"
	ONE name="Kut"
	ONE_PREF name="Karis"
	ONION name="Grille"
	OOZE name="Hore"
	OPEN name="Kubet"
	ORB name="Hunya"
	OVER name="Kagov"
	OWL name="Hes"
	OX name="Lelle"
	PACK name="Menye"
	PAD_NOUN name="Karwa"
	PAD_VERB name="Morwa"
	PAGE name="Genya"
	PAIN name="Fleme"
	PAINT name="Hurall"
	PALE name="Jober"
	PALM name="Osoga"
	PANT name="Kerar"
	PANTHER name="Korwunye"
	PANTS name="Hille"
	PAPER name="Hurare"
	PEACE name="Onuser"
	PEACH name="Earev"
	PEPPER name="Karulle"
	PHLEGM name="Howlane"
	PIG name="Mille"
	PIT name="Raga"
	PITCH name="Ollome"
	PLAGUE name="Konyall"
	PLANT name="Orulle"
	PLANTER name="Gerulle"
	PLOT name="Monut"
	POCKET_NOUN name="Lasulle"
	POCKET_VERB name="Konulle"
	POISON name="Gorall"
	PORTAL name="Hurirur"
	POWER name="Kasara"
	PRANK name="Jielle"
	PREGNANT name="Flestalla"
	PRIDE name="Orera"
	PRIEST name="Gukewle"
	PRIM name="Olla"
	PRIME name="Karome"
	PRIMITIVE name="Hebamubugar"
	PROFANE name="Peraball"
	PROPHECY name="Gieradge"
	PROPHET name="Lerowlav"
	PROWL name="Heriba"
	PUKE name="Rana"
	PULL name="Strus"
	PULLEY name="Hureget"
	PULP name="Hona"
	PUNCH name="Lokada"
	PURPLE name="Ondumer"
	PUS name="Homa"
	PUTRID name="Hollude"
	QUAKE name="Kobada"
	QUEEN name="Mubus"
	QUICK name="Pamm"
	QUILL name="Grerwa"
	RABBIT name="Ononye"
	RABBLE name="Musume"
	RACE_GROUP name="Flon"
	RACE_VERB name="Onere"
	RACK name="Pida"
	RAG name="Onar"
	RAGE name="Oreme"
	RAIN name="Lenye"
	RAKE name="Hida"
	RAM name="Penye"
	RAMPAGE name="Henobuda"
	RANDOM name="Hupuge"
	RANSACK name="Eadorada"
	RAPTOR name="Makonye"
	RAT name="Kech"
	RAUNCH name="Howlura"
	RAVAGER name="Paredada"
	RAVEN name="Flumos"
	RAW name="Hagar"
	RAZOR name="Kapeda"
	RED name="Meber"
	REGAL name="Mukara"
	REIGN name="Karera"
	REIN name="Kaba"
	REND name="Rurar"
	RIDER name="Earana"
	RIM name="Hurur"
	RING_OBJECT name="Hurat"
	RING_SOUND name="Kimm"
	RIP name="Hella"
	RIPE name="Ginye"
	RIPPER name="Hondada"
	RISE name="Rakos"
	RITE name="Mosta"
	RIVER name="Opanye"
	ROCK name="Okar"
	ROGUE name="Okame"
	ROMANCE name="Horagamm"
	ROOM name="Huras"
	ROOMY name="Hurav"
	ROOT name="Lonye"
	ROSE name="Okamm"
	ROT name="Jome"
	ROUGH name="Huropa"
	ROYAL name="Karama"
	RUIN name="Lune"
	RUIN_V name="Eada"
	RULER name="Orugo"
	RUMOR name="Heroba"
	RUST name="Keene"
	SABRE name="Manida"
	SACK name="Jenar"
	SAINT name="Meepev"
	SALT name="Osome"
	SALVE name="Hudana"
	SAP name="Kepin"
	SATIN name="Hurepa"
	SAVAGE name="Maborar"
	SAVAGERY name="Odullarar"
	SAVIOR name="Flagev"
	SCAB name="Pada"
	SCAR name="Leda"
	SCOLD name="Mokoda"
	SCORPION name="Ranyokada"
	SCRATCH name="Rullada"
	SCOURGE name="Rurarall"
	SCREAM name="Kallech"
	SCUM name="Hodo"
	SEA name="Ogut"
	SEAL_ANIMAL name="Orwut"
	SEAL_ART name="Hidan"
	SEAM name="Huruv"
	SEASON name="Flanone"
	SECRET name="Hereera"
	SEDUCE name="Mumasa"
	SEDUCER name="Rakogall"
	SEED name="Lopas"
	SEER name="Herev"
	SEIZE name="Manada"
	SERPENT name="Kareme"
	SERVANT name="Kestadge"
	SEVER name="Ostat"
	SEWER name="Harome"
	SHADOW name="Herenye"
	SHAFT name="Rado"
	SHANK name="Puch"
	SHARK name="Heeda"
	SHEAR name="Mieda"
	SHEEN name="Husura"
	SHELL name="Larwa"
	SHELTER name="Rullille"
	SHIELD name="Josawla"
	SHIMMER name="Husodomm"
	SHIP name="Rukut"
	SHOOT name="Rieda"
	SHOW name="Handa"
	SHRED name="Flulla"
	SHRIEK name="Kendame"
	SHUT name="Peme"
	SICK name="Purut"
	SICKNESS name="Jinyarome"
	SIEGE name="Fluda"
	SILENCE name="Herenobo"
	SILK name="Huror"
	SILKY name="Regamm"
	SILT name="Kebis"
	SILVER name="Eadudun"
	SIN name="Hall"
	SINEW name="Gumoda"
	SING name="Jolla"
	SISTER name="Kugolla"
	SKIRT_CLOTHING name="Huripa"
	SKIRT_VERB name="Horame"
	SKUNK name="Gamuda"
	SKULL name="Oregut"
	SKY name="Jinye"
	SLAUGHTER name="Eadindada"
	SLAVE name="Kenuba"
	SLAYER name="Mulla"
	SLIM name="Mime"
	SLIME name="Keba"
	SLING name="Orada"
	SLINK name="Monill"
	SLIT name="Hopes"
	SLITHER name="Kewlobat"
	SLIVER name="Gurwome"
	SLOTH name="Ganome"
	SLUG name="Lunye"
	SMASH name="Manoda"
	SMILE name="Ogalla"
	SMITH name="Hurama"
	SMOKE name="Olluda"
	SMOOTH name="Rorwo"
	SMOULDER name="Mamierome"
	SNACK name="Jaelle"
	SNAKE name="Ponye"
	SNEER name="Kabome"
	SNOT name="Home"
	SNUGGLE name="Odadulle"
	SOIL name="Wryna"
	SOLDIER name="Oragada"
	SOOT name="Paeme"
	SOOTHE name="Jellera"
	SORROW name="Flabame"
	SOUL name="Lubav"
	SOUND name="Flara"
	SOUTH name="Hallis"
	SPASM name="Madume"
	SPAWN name="Rirome"
	SPEAR name="Hures"
	SPELL name="Padar"
	SPICE name="Earore"
	SPIDER name="Paranye"
	SPIDERY name="Hellunye"
	SPIKE name="Pama"
	SPIN name="Grara"
	SPINE name="Hegema"
	SPIRIT name="Kadona"
	SPIT name="Homm"
	SPITTLE name="Howlarwo"
	SPOIL name="Pulla"
	SPOON name="Hurada"
	SPRING_NOUN name="Gorulle"
	SPRING_SEASON name="Kellas"
	SPRING_VERB name="Morulle"
	SPRY name="Gras"
	SPY name="Hame"
	SQUID name="Ondut"
	SQUIRM name="Kullome"
	STAB name="Gaeda"
	STAFF name="Hurira"
	STALK name="Lume"
	STAND name="Earura"
	STAR name="Liera"
	STEED name="Kaelle"
	STARVE name="Hobenda"
	STEAL name="Pome"
	STEEL name="Hubora"
	STENCH name="Howledo"
	STERN name="Kedura"
	STICK_WOOD name="Ruka"
	STICK_VERB name="Omille"
	STICKY name="Grume"
	STONE name="Obekus"
	STORM name="Puroda"
	STRANGE name="Lareme"
	STRAP name="Midara"
	STRAPPING_ADJ name="Godgallas"
	STRAW name="Meelle"
	STRAY name="Homech"
	STRENGTH name="Flierwara"
	STRETCH name="Gerome"
	STRIKE name="Leeda"
	STROKE name="Stranya"
	STUNT name="Kewlur"
	STUNTED name="Kewlena"
	STUPID name="Karweme"
	STUTTER name="Gonume"
	STYLE name="Golla"
	SUBORDINATE name="Kesesarulla"
	SUCK name="Hono"
	SUFFERING name="Pareraeme"
	SUGAR name="Earopa"
	SULLY name="Howlan"
	SULLEN name="Leebome"
	SUMMER name="Puranye"
	SUN name="Onune"
	SUNDER name="Floduda"
	SUPPER name="Redalle"
	SURPRISE name="Karellech"
	SWAMP name="Kawla"
	SWEAT name="Horas"
	SWEET name="Earara"
	SWIFT name="Henura"
	SWIM name="Kigut"
	SWINE name="Judga"
	SWORD name="Purus"
	SYRUP name="Hurude"
	TAKER name="Mesura"
	TAIL name="Hades"
	TALON name="Godeda"
	TAR name="Eame"
	TARNISH name="Graemome"
	TELL name="Jure"
	TEMPEST name="Luraroda"
	TEAR name="Mame"
	TERROR name="Lusall"
	THIEF name="Himall"
	THIRST name="Pandome"
	THORN name="Mabus"
	THRALL name="Kewlode"
	THREE name="Mudimm"
	THROAT name="Musas"
	THRONE name="Gagirus"
	THROWER name="Flanyuda"
	THUNDER name="Megegada"
	TICK_ANIMAL name="Onall"
	TICK_CLOCK name="Mugav"
	TIGHT name="Kedgo"
	TIME name="Flone"
	TOAD name="Horos"
	TOE name="Jas"
	TOMB name="Gane"
	TOME name="Grane"
	TONGUE name="Earell"
	TOOTH name="Parar"
	TORMENT name="Ganedada"
	TOUCH name="Kene"
	TOUCHY name="Kubome"
	TOUR name="Hurus"
	TOWER name="Gundus"
	TRAIL name="Koroka"
	TRANCE name="Pandode"
	TRAP name="Keda"
	TRASH name="Mebume"
	TREASURE name="Kelludas"
	TREAT name="Okulle"
	TREATY name="Hurawle"
	TRENCH name="Gastus"
	TRIBE name="Kabar"
	TRICK name="Heran"
	TRICKERY name="Gellome"
	TRIM name="Palla"
	TROUBLE name="Muwlome"
	TUG name="Pelle"
	TULIP name="Omalla"
	TUMBLE name="Gekome"
	TUMOR name="Horika"
	TURMOIL name="Girapame"
	TUSK name="Jada"
	TWEET name="Maenye"
	TWILIGHT name="Goraredo"
	TWINE name="Odolle"
	TWIST name="Mika"
	TWO name="Kov"
	UGLY name="Howlo"
	ULCER name="Murome"
	ULTIMATE name="Karierema"
	ULTRA name="Karur"
	UNBRIDLED name="Kagallech"
	UNCLE name="Gawlat"
	UNGODLY name="Leerall"
	UNHOLY name="Madgall"
	UNKEMPT name="Graesech"
	UNSEEN name="Heropo"
	UNTOWARD name="Kostegame"
	UNWELCOME name="Kusaererome"
	URN name="Huga"
	USELESS name="Gadudome"
	VANDAL name="Pobome"
	VEGETABLE name="Ririnerome"
	VEGETATE name="Opurugome"
	VEGETATION name="Gurugarenye"
	VELVET name="Hugalla"
	VENOM name="Genime"
	VERMIN name="Kewliba"
	VILE name="Jarwa"
	VIOLATOR name="Pasenulla"
	VIOLENCE name="Keestada"
	VIOLET name="Libeber"
	VIPER name="Odunye"
	VOICE name="Jurare"
	VOID name="Heme"
	VOLCANO name="Flusteda"
	VOMIT name="Hodiev"
	VULTURE name="Kadellut"
	WAIL name="Keme"
	WANDER name="Hallisa"
	WAR name="Goda"
	WARRIOR name="Kebaeda"
	WASP name="Jonye"
	WASTE name="Medger"
	WATCH name="Flarwa"
	WATCHFUL name="Gamadanya"
	WAVE name="Mogut"
	WAVY name="Gella"
	WEAR name="Maene"
	WEASEL name="Pedonye"
	WEAVER name="Gerolly"
	WEED name="Gume"
	WEIGHT name="Gisebe"
	WEIRD name="Kapome"
	WERE name="Kondo"
	WEST name="Halla"
	WHEAT name="Grolle"
	WHEEL name="Hurach"
	WHIP name="Hube"
	WHISK name="Paelle"
	WHISKY name="Odgulle"
	WHISPER name="Herake"
	WHITE name="Raber"
	WICKED name="Gadall"
	WILD name="Mech"
	WILL name="Rera"
	WING name="Gape"
	WINTER name="Papav"
	WISP name="Kulla"
	WITCH name="Kamall"
	WONDER_NOUN name="Karilla"
	WONDER_VERB name="Gunyara"
	WOOD name="Meena"
	WORK name="Hunor"
	WORM name="Kenat"
	WRAITH name="Gallut"
	WRATH name="Herur"
	WRETCH name="Kenena"
	YARN name="Kelly"
	YEAR name="Flane"
	YEARLING name="Kullugech"
	YELLOW name="Loster"
	YOR name="Kine"
	YOUNG name="Gullas"
	YOUTH name="Pipas"
	ZEAL name="Odech"
	ZEALOT name="Mabech"
	ZEPHYR name="Harolla"
	EARTH name="Eade"
	ARTIFACT name="Hurerara"
	BED name="Hur"
	BUD name="Ostas"
	CAVORT name="Kedolla"
	COMMON name="Medgusa"
	DAUB name="Mesa"
	DESERT name="Mopunye"
	DESSERT name="Pusolla"
	DIAMOND name="Geereer"
	DOMAIN name="Orusera"
	DREAM name="Herov"
	TIN name="Eados"
	COPPER name="Eaduro"
	BRONZE name="Eadude"
	GRANITE name="Eadagas"
	FANCY name="Lolla"
	FARM name="Ralle"
	FIELD name="Flena"
	FROTH name="Hogire"
	GENIUS name="Gakanya"
	GLACIER name="Ranunye"
	GURGLE name="Howlena"
	IMPALE name="Gonulla"
	JOIN name="Kado"
	JADE name="Loder"
	IVORY name="Kunyas"
	LAND name="Kuch"
	LATHER name="Lerella"
	LIMP name="Kenut"
	LUCID name="Kandor"
	MOUNTAIN name="Eadubus"
	MUCUS name="Howlas"
	PATTERN name="Kunyonye"
	PEBBLE name="Kegene"
	BOULDER name="Eadarara"
	PETAL name="Mapamm"
	DROPLET name="Gadolla"
	PINNACLE name="Osarukus"
	PLAIN name="Eabos"
	PLAINADJ name="Jorar"
	POINT name="Grurus"
	POT name="Hure"
	PRAIRIE name="Jastonye"
	RUSH name="Keras"
	SLAP name="Kaeka"
	SLEEVE name="Huredon"
	SPECK name="Keboch"
	STEPPE name="Japuna"
	TENTACLE name="Mupapanye"
	TEST name="Grus"
	TROT name="Kupas"
	TUB name="Okor"
	TUBE name="Lamm"
	TUNDRA name="Gonunye"
	UN name="Ealla"
	WADDLE name="Keebome"
	WEALTH name="Jamodas"
	WEEVIL name="Kandach"
	WHIM name="Labas"
	WHIRL name="Marech"
	WORLD name="Oros"
	DESERTVERB name="Kagolla"
	FANCYVERB name="Mamm"
	LIMPVERB name="Kede"
	POINTVERB name="Ranyo"
	PANTOMIME name="Kanarorolla"
	SLUDGE name="Kurame"
	GOO name="Eawla"
	REALM name="Easopa"
	PLANE name="Orunye"
	DIMENSION name="Oruniedulle"
	UNIVERSE name="Oromopega"
	PLANET name="Oraraka"
	LIVID name="Kapech"
	TEPID name="Mekome"
	HONEST name="Merega"
	KINGDOM name="Easeris"
	EMPIRE name="Easada"
	CONFEDERATION name="Easonokogeraste"
	SIMPLE name="Mokar"
	TROOPER name="Marida"
	CRIMSON name="Huraber"
	DUNE name="Guber"
	DIRECT name="Geerura"
	CLASH name="Maech"
	FOREVER name="Ganorane"
	SUBTLE name="Heruren"
	PUPPET name="Huredav"
	HEGEMON name="Karerera"
	AMAZE name="Kepa"
	ALCHEMY name="Pandumm"
	INSIGHT name="Gellonya"
	UNION name="Easuro"
	CONFEDERACY name="Easorurageega"
	SPEAK name="Flalla"
	SPEAKER name="Merumm"
	PERSUADE name="Gastomara"
	PERSUADER name="Gupallarura"
	CONTROL name="Odosera"
	CONTROLLER name="Porenyonara"
	WORKER name="Kapuna"
	BASIC name="Gidoch"
	SYSTEM name="Flanye"
	RAY name="Husa"
	TARGET name="Orurada"
	BANK name="Kora"
	CLEAN name="Haras"
	DRIVE name="Hosora"
	SOAR name="Joka"
	GLORY name="Gobun"
	DISMAL name="Maesome"
	RADIANCE name="Konarera"
	PINE name="Kipov"
	MESSIAH name="Karorura"
	CRAFT name="Hurwut"
	LABOR name="Hurot"
	DISCOVER name="Gaedarune"
	PROLIFERATE name="Manyestemunon"
	CHUNK name="Hanome"
	SLIP name="Hunen"
	SLIDE name="Jerus"
	SINGLE name="Odgan"
	PICK name="Hudga"
	TONGS name="Hurena"
	PERMANENCY name="Gastudune"
	RESPONSIBLE name="Grunusuwles"
	REQUIRE name="Hagana"
	ROOTVERB name="Roda"
	BLIZZARD name="Kunarav"
	GENERAL name="Karubusa"
	MEMORY name="Ganaera"
	CONSTRUCT name="Hururodgall"
	LAMB name="Kewlo"
	TOAST name="Lille"
	GROSS name="Owlame"
	PADDLE name="Lugut"
	COUNCIL name="Hekusa"
	COUNSEL name="Pirurabe"
	GNARLED name="Horeerar"
	STUMP name="Meenye"
	NAUGHTY name="Onyume"
	PLAY FUN name="Easta"
	PLAY PERFORM name="Kusta"
	FLIMSY name="Eandome"
	GREATER name="Rewlara"
	GREATEST name="Karanusar"
	LESSER name="Ororume"
	LEAST name="Onyome"
	BEARD name="Pinye"
	DREAD name="Mullut"
	WALL name="Hurun"
	WALLOW name="Howlake"
	TAX name="Kas"
	FRAGRANCE name="Eariedosiv"
	LANTERN name="Husaera"
	TORCH name="Rora"
	WATER name="Jellut"
	WINE name="Reka"
	LINE name="Kanan"
	MINE name="Raget"
	WAX name="Gas"
	SHOVE name="Gikada"
	SHOVEL name="Punolle"
	MELT name="Poda"
	WRACK name="Hosada"
	GLITTER name="Oremalla"
	SPARK name="Husoch"
	SPARKLE name="Husoduch"
	FLASH name="Husuda"
	GLEAM name="Strera"
	RUN name="Orech"
	DASH name="Kirwa"
	SAVANT name="Gerunya"
	ROAR name="Kanar"
	YELL name="Gora"
	ECHO name="Ragev"
	HOLLOW name="Ragura"
	FULL name="Mopa"
	EMPTY name="Rulla"
	WORD name="Geell"
	INTENSE name="Mapisech"
	SAD name="Odo"
	GLAD name="Horev"
	TRAGEDY name="Kollome"
	BELL name="Hurin"
	BELLY name="Earit"
	TUMMY name="Haelle"
	SHOCK name="Midada"
	PONDER name="Kopanya"
	PONDEROUS name="Stralluran"
	HEAVEN name="Onadope"
	ROUND name="Lobe"
	ROUNDED name="Ogeemaka"
	UNSPEAKABLE name="Heradanyedgus"
	UNTHINKABLE name="Hakaerwakime"
	UN NAMEABLE name="Piboneeme"
	CALAMITY name="Kadosulla"
	CYCLOPEAN name="Onudawlav"
	TAME name="Midas"
	UNTAMED name="Gororar"
	BURST name="Ostada"
	METEOR name="Mebira"
	TRITE name="Murame"
	TRIFLE name="Jumome"
	RANK name="O name"
	RANCOR name="Horowla"
	BITTER name="Ja name"
	SOUR name="Kose"
	DANGER name="Rupeda"
	IMPERVIOUS name="Hereebore"
	UNSWERVING name="Pasturandura"
	SWAY name="Hulla"
	LUXURY name="Kuraras"
	EUPHORIA name="Momalla"
	SCINTILLATE name="Husieboranda"
	DIVINE name="Ledarev"
	DIVIDE name="Marella"
	TAINT name="Honana"
	CORRUPT name="Gremolla"
	MALIGN SLANDER V name="Gunall"
	MALIGN ADJ name="Osaeme"
	MALIGNANT name="Gokasteeme"
	TRUST name="Ollev"
	DISTRUST name="Kadgame"
	TRUSTWORTHY name="Morallegoll"
	UNTRUSTWORTHY name="Wrynogabagome"
	DISHONEST name="Rerullademe"
	BLIGHT name="Masut"
	CUNNING name="Kadiba"
	SLY name="Mege"
	RUSTIC name="Hururo"
	HOMELY name="Hagulle"
	LONELY name="Gustame"
	LONESOME name="Maramume"
	CLOSE name="Murure"
	FORD name="Kires"
	WAY name="Mesta"
	WAYWARD name="Hallanya"
	BANDIT name="Hebada"
	BRIGAND name="Mabame"
	MONSTER name="Labada"
	SENSE name="Kinyov"
	INSENSITIVE name="Karwogamerome"
	SENSUAL name="Jugukamm"
	ODOR name="Hena"
	MALODOROUS name="Penderastame"
	IGNORANT name="Megidome"
	IGNOBLE name="Hellume"
	HUMBLE name="Oneesta"
	MORAL name="Fledev"
	IMMORAL name="Ollarume"
	SUPERIOR name="Karudere"
	INFERIOR name="Horaeme"
	INFINITE name="Reridav"
	SABLE COLOR name="Haella"
	FELL CRUEL name="Grera"
	FELL HIDE name="Porar"
	PELT HIDE name="Korar"
	DIGNITY name="Harorwev"
	UNDIGNIFIED name="Kusustidgame"
	INDIGNATION name="Ladaedgagara"
	RIGHT BETTER name="Gorura"
	ABSOLUTE name="Pedgakira"
	FAIR EVEN name="Ogere"
	FAIR COLOR name="Jaker"
	SNARL name="Strar"
	LOYAL name="Munev"
	DISLOYAL name="Medurome"
	HELP name="Marwa"
	FRIEND name="Mierwev"
	COURTESY name="Marwurev"
	CHEERFUL name="Hedarwev"
	THRIFT name="Honulle"
	BRAVERY name="Gullera"
	REVERE name="Munuwle"
	VENERATE name="Magumene"
	SALUTE name="Kenage"
	NATION name="Easesar"
	DRINK name="Puge"
	CONSIDERATE name="Manyunesierev"
	CONVENIENT name="Orosemulle"
	INCONSIDERATE name="Hebebomenyome"
	INCONVENIENT name="Haegiedgodalle"
	CONTINENT name="Keduremuch"
	FLIGHT name="Gokanye"
	FLIGHTY name="Laesome"
	GILD name="Kedas"
	GUILD name="Huris"
	MERCHANT name="Kemereech"
	TRADE name="Lirer"
	PLAIT name="Munda"
	BRAID name="Kuna"
	PLEAT name="Hike"
	FOLD name="Jeera"
	BUNION name="Horebor"
	UNCOMMON name="Hedgora"
	RARE name="Mere"
	SCARCE name="Geella"
	REMARKABLE name="Karenyeerara"
	UNREMARKABLE name="Kewlerunenan"
	SOLITARY name="Gunaraga"
	BEND name="Odut"
	BLAME name="Kademe"
	BLAMELESS name="Omamonowlev"
	TWIG name="Kuge"
	GIRDER name="Huragos"
	TRUSS name="Midat"
	SKEWER name="Mideda"
	SCULPT name="Mowlara"
	TRESS name="Grulla"
	LOCK HAIR name="Huma"
	CURL name="Gally"
	TUFT name="Kurar"
	MEAN NASTY name="Jeme"
	MEAN LOW name="Lenar"
	SHAME name="Strome"
	ASHAMED name="Godulla"
	STEAM name="Hegada"
	FERN name="Kull"
	FERRY name="Hurure"
	GULLY name="Okanye"
	WORRY name="Mukume"
	LION name="Rinye"
	CACTUS name="Huranye"
	DESK name="Huwlo"
	BOTTLE name="Gonulle"
	SHINGLE name="Kanyulle"
	BLANKET name="Gierorwa"
	CLOUD name="Liella"
	PLATE name="Hurara"
	ROAD name="Merir"
	HOUSE name="Hurobe"
	BEAN name="Flur"
	BLOCK DEFEND name="Oberwa"
	BLOCK SQUARE name="Hude"
	FOUNTAIN name="Gakellas"
	PEARL name="Grenye"
	PEAR name="Eadet"
	THIMBLE name="Geerolle"
	BUNNY name="Kielle"
	ROPE name="Huran"
	STRING name="Gadelle"
	WIRE name="Huros"
	LASH name="Rida"
	SORCERY name="Pandada"
	SORCERER name="Pandupasa"
	ENSORCEL name="Madubulla"
	BEWITCH name="Paredame"
	MAGICIAN name="Pandonare"
	CONJURE name="Paburamm"
	CONJURER name="Pandomike"
	ENCHANT name="Mollasav"
	ENCHANTER name="Panyeenadge"
	LANCE name="Huresa"
	LANCER name="Ogadada"
	STINK name="Onyeme"
	FRECKLE name="Wrynuber"
	PIMPLE name="Grudome"
	WART name="Mieme"
	BLOTCH name="Howluda"
	CALLUS name="Horuba"
	WIND STORM name="Ledav"
	WIND CLOCK name="Huro"
	HAZE name="Mana"
	SKIN name="Flor"
	SHIN name="Gramm"
	TORTURE name="Omurada"
	TOOL name="Hurut"
	SCHOLAR name="Labanya"
	WEEP name="Rume"
	MASSIVE name="Mabora"
	LARGE name="Padura"
	SMALL name="Kewluv"
	LOAF name="Marwe"
	TILE name="Huriv"
	SPORT name="Onura"
	SEARCH name="Ollura"
	STALE name="Konome"
	FRESH name="Kerwas"
	RUB name="Kamm"
	WORTHY name="Karev"
	WORTHLESS name="Grirumulla"
	FRIGHT name="Kallome"
	REVOLTING name="Odgadurome"
	DISGUST name="Hogomo"
	OUTRAGE name="Mosemada"
	CRUEL name="Onome"
	DEVIANT name="Karobome"
	DEVIOUS name="Hunome"
	FABULOUS name="Madapolla"
	MORALITY name="Kiemullev"
	IMMORALITY name="Omestarorall"
	SKIN VERB name="Gieda"
	SKINNY name="Larure"
	NARROW name="Junada"
	GRIEF name="Mapame"
	BELT name="Mido"
	SANDAL name="Mokus"
	FUTURE name="Mukaras"
	PAST name="Jaene"
	PRESENT name="Oralle"
	BITE name="Karar"
	SPLIT name="Omach"
	BRASH name="Gadech"
	BRAZEN name="Ganeme"
	STRANGLE name="Kakilla"
	GALLOWS name="Ollollut"
	MUSCLE name="Eaboso"
	DIM name="Milla"
	SPURT name="Howlus"
	GRAVEL name="Eadara"
	RISK name="Pella"
	CHANCE name="Kunon"
	CHANNEL name="Hurarure"
	MIRTH name="Earwev"
	GLEE name="Orwev"
	VICTIM name="Porwume"
	STRANGER name="Hallaga"
	DRAB name="Haeme"
	VISION name="Jirogav"
	VISIONARY name="Mogedonya"
	ORACLE name="Hurerav"
	UTTER name="Konyer"
	DECIDE name="Kedages"
	DECISIVE name="Rarwidira"
	SPECIAL name="Honurura"
	AUTHOR name="Kaellet"
	AUTHORITY name="Garaeronull"
	PORTENT name="Grunarav"
	MOMENTOUS name="Kadunodgav"
	INFALLIBLE name="Omaerida"
	AMBIGUOUS name="Leenumare"
	CURIOUS name="Kendera"
	OBSCURE name="Herarwar"
	OBSCENE name="Kondulla"
	OBSTACLE name="Midumire"
	VULGAR name="Haralla"
	OMINOUS name="Mepodume"
	ISLAND name="Orinye"
	CHURCH name="Gubev"
	TEMPLE name="Hadebev"
	CULT name="Jurit"
	COVEN name="Mabit"
	SECT name="Gakit"
	ORDER GROUP name="Rasit"
	CREED name="Korit"
	COMMUNION name="Madganawle"
	DOCTRINE name="Opurunit"
	FAITH name="Oramit"
	DENOMINATION name="Gerakustiedgit"
	TEMPLE HEAD name="Mollada"
	OCCULT name="Hereema"
	ORDER CONCEPT name="Osta"
	FAITH LOYALTY name="Kugull"
	GUILT name="Lonome"
	BABY name="Garet"
	BLEED name="Kukida"
	GIRL name="Gamet"
	BOY name="Gawle"
	WOMAN name="Gadera"
	FLAG name="Gesta"
	BANNER name="Henasta"
	WREATH name="Strusta"
	STANDARD FLAG name="Hurosura"
	TRUMPET name="Kidgeris"
	GOAL name="Osura"
	JAIL name="Midiv"
	PRISON name="Miderwe"
	LIBRARY name="Kanunya"
	AVALANCHE name="Eaderaras"
	STIGMA name="Eakame"
	SLICK name="Odgana"
	TALK name="Kupa"
	JAILER name="Labella"
	STILL UNMOVING name="Honiv"
	CALM name="Onapa"
	HUSH name="Kariv"
	LACONIC name="Garonyiv"
	LULL name="Maniv"
	MUTE name="Pudiv"
	NOISELESS name="Hukubulliv"
	QUIESCENT name="Heellulliv"
	QUIET name="Lelliv"
	RETICENT name="Kokobiv"
	SATURNINE name="Rarakelliv"
	SPEECHLESS name="Musirolliv"
	TACITURN name="Mewlende"
	FORTUNE LUCK name="Gakudon"
	FORTUNE WEALTH name="Oraras"
	ACCIDENT name="Oropudon"
	CIRCUMSTANCE name="Stridgenenekon"
	CONTINGENT name="Hustastalla"
	CONTINGENCY name="Flustandapon"
	COINCIDENCE name="Ganyuwlarodon"
	FLUKE name="Ganon"
	LUCK name="Lekon"
	CERTAIN name="Hestara"
	UNCERTAIN name="Kerunyudon"
	FORTUITOUS name="Mugonodon"
	INCIDENTAL name="Rodgalladgon"
	AMUSE name="Gegoge"
	PASTIME name="Hirwuge"
	DISTRACT ANNOY name="Kigalla"
	DISTRACTION GAME name="Ganedanyuge"
	DIVERSION GAME name="Manaruge"
	DIVERT DETOUR name="Kepalla"
	RECREATION GAME name="Jonipepuge"
	COMPETE name="Odieroge"
	CONTEST name="Monoge"
	MATCH CONTEST name="Maroge"
	MATCH EQUAL name="Ogulla"
	TOUR NAMENT name="Geserowluge"
	PLAN name="Gruge"
	SCENARIO name="Madaerige"
	STRATEGY name="Kollanya"
	TACTIC name="Jalluge"
	AUTONOMY name="Koreegara"
	EMANCIPATE name="Korasudarwe"
	EXTRICATE name="Kowlokodaba"
	IMPUNITY name="Kodgonev"
	LIBERATE name="Kolloroda"
	LIBERTY name="Kowlera"
	RELEASE name="Kokurope"
	RELIEVE name="Kesuses"
	EVEN name="Ogera"
	BALANCE name="Ogador"
	EQUITY name="Oganamm"
	EQUIVALENCE name="Ogarasopadan"
	PARITY name="Ogusare"
	STASIS name="Ogisara"
	SYMMETRY name="Wrynunye"
	EQUAL name="Ogarot"
	HARMONY name="Oguruna"
	NEUTRALIZE name="Oguramuruna"
	NEUTRAL name="Ogendupa"
	STABLE UNCHANGING name="Ogebure"
	LULL MISLEAD name="Flar"
	DOUR name="Gieme"
	GLOOM name="Jurome"
	SEVERE name="Koriera"
	GLUM name="Rime"
	IMAGE name="Genda"
	SHRINE name="Gurewle"
	SANCTUARY name="Eawlorurwa"
	MONASTERY name="Minustagev"
	CONVENT name="Raellev"
	CATHEDRAL name="Kudadgev"
	CHAPEL name="Gorev"
	SANCTUM name="Kudadev"
	INFERNO name="Gumara"
	CONFLAGRATION name="Gekorwudgeenura"
	FLARE name="Hadera"
	HEAT name="Onera"
	SAND name="Luba"
	PILLAR name="Hurobus"
	COLUMN name="Gerage"
	ARCH NOUN name="Huret"
	GROTTO name="Gasanye"
	CAVERN name="Goronde"
	DEPTH name="Ragas"
	SHADE name="Goripe"
	VEIL name="Here"
	RELIC name="Lakane"
	UMBRA name="Rageke"
	PHANTOM name="Lasastut"
	MURK name="Kuwla"
	FAINT INTENSITY name="Gorare"
	FAINT VERB name="Malliv"
	SOMBER name="Maredut"
	TENEBROUS name="Heradeedese"
	MOROSE name="Odaneme"
	LOVER name="Kanamm"
	BELOVED name="Lapobamm"
	ESCORT name="Lurerwa"
	SUITOR name="Obigamm"
	PUNGENT name="Oralla"
	MUSTY name="Hadome"
	INFECT name="Flepome"
	LESION name="Gumume"
	AFFLICT name="Odgerome"
	ACHE name="Geme"
	EPIDEMIC name="Likiebeme"
	FIGHT name="Konuda"
	SCUFFLE name="Mollalle"
	YAWN name="Guro"
	ACTION name="Kenyura"
	ASSAULT name="Jododa"
	CARNAL name="Gollamm"
	STRIFE name="Haeda"
	COMBAT name="Gorida"
	CITADEL name="Peburora"
	CITY name="Osaen"
	TOWN name="Hurov"
	VILLAGE name="Hurarora"
	MANOR name="Hullas"
	MANSION name="Hurinda"
	PALACE name="Hurarar"
	COTTAGE name="Ganulle"
	SHACK name="Huremm"
	HUT name="Kenus"
	HOVEL name="Hurudo"
	BASTION name="Penarat"
	FURNACE name="Kogeera"
	ANVIL name="Hurasa"
	BRIDGE name="Halluma"
	SAFE name="Rerwa"
	GOAD name="Kime"
	MACHINE name="Hudanyur"
	FLAY name="Kaeda"
	OIL name="Eadin"
	SUICIDE name="Eanirome"
	MARBLE BALL name="Luralle"
	BAIT name="Kere"
	LURE name="Morot"
	REWARD name="Pukomm"
	WARD name="Orwa"
	PRICE name="Oneech"
	PRINCE name="Karada"
	PRINCESS name="Karurube"
	TEMPT name="Hallar"
	SPURN name="Jisome"
	SCORN name="Jame"
	CONTEMPT name="Merarilla"
	AFFECTION name="Orumogamm"
	COMPASSION name="Murerwaemev"
	SACRIFICE name="Puraperwev"
	CHARITY name="Mamurev"
	CHERISH name="Manolla"
	TRAMPLE name="Kiparan"
	MALICE name="Kereme"
	HATRED name="Flirame"
	SPITE name="Kurome"
	SHORE name="Rallan"
	BEACH name="Gupan"
	COAST name="Kadut"
	INSECT name="Kewlobe"
	BUG name="Kebes"
	CRITTER name="Jadulle"
	BRUTE name="Gikech"
	PET name="Groda"
	BARBARIAN name="Gabadadurar"
	HARSH name="Eageme"
	PRISTINE name="Moninanye"
	FEROCITY name="Hubigech"
	BARBARITY name="Hakasurada"
	FERAL name="Mopar"
	FURY name="Kuda"
	RUTHLESS name="Pullunall"
	GORE NOUN name="Oreda"
	CHAMPION name="Ramestara"
	VIRTUE name="Jubonev"
	SCANDAL name="Mamanome"
	APOGEE name="Kamura"
	SPIRE name="Grone"
	SPIRAL name="Josar"
	CLIMAX name="Lindura"
	CLIMATE name="Gureda"
	WEATHER name="Hadanye"
	CREST name="Rema"
	CULMINATE name="Jillowlira"
	CUSP name="Mise"
	MOST name="Grura"
	PEAK name="Hibus"
	BLUNT name="Kunya"
	ROOF name="Hugur"
	CEILING name="Hurepar"
	FLOOR name="Hurora"
	SUMMIT name="Hupabus"
	TIP name="Kadge"
	TOP name="Rura"
	BOTTOM name="Kerwara"
	SIDE name="Gully"
	ZENITH name="Karonde"
	FLANK VERB name="Greech"
	PASS MOUNTAIN name="Gosa"
	PASS VERB name="Hara"
	PASSAGE name="Lollunas"
	CORRIDOR name="Huredape"
	HALL name="Koras"
	GALLERY name="Herawle"
	GALLEY name="Hurilla"
	ARENA name="Humara"
	ARMORY name="Huraba"
	ASSEMBLE name="Mallasta"
	MEET name="Jasta"
	THEATER name="Hurener"
	ENTRANCE name="Gellodga"
	EXIT name="Grora"
	ENTRY name="Orora"
	VESTIBULE name="Flekisech"
	FROST name="Strach"
	FEVER name="Kegepa"
	HUMID name="Grapa"
	HUMOR name="Obasta"
	COMEDY name="Habusta"
	SIZZLE name="Herera"
	SWELTER name="Lukora"
	WARM name="Maera"
	TORRID name="Garura"
	ACRID name="Godome"
	DALE name="Linye"
	DELL name="Raken"
	GLADE name="Keenye"
	VALE name="Kaso"
	BASIN name="Kanis"
	BOWL name="Fluv"
	CAVITY name="Muriesa"
	CRATER name="Kanas"
	DEN name="Grede"
	DENT name="Hoda"
	DEPRESS SAD name="Kagumome"
	DEPRESSION LOW name="Korusonyes"
	DIMPLE name="Kenan"
	DIP name="Liere"
	DISH name="Kawlo"
	EXCAVATE name="Hulleduda"
	GROOVE name="Kiellos"
	GULF SEA name="Giepa"
	GULF PIT name="Fluba"
	GULF DISTANCE name="Eally"
	DISTANCE name="Maropaga"
	NOTCH name="Goruch"
	SAG name="Orame"
	SCOOP name="Kusa"
	SOCKET name="Kanara"
	TROUGH name="Hurana"
	VALLEY name="Geranye"
	FENCE name="Husav"
	BARRICADE name="Hurapandana"
	BLOCKADE name="Hureras"
	BOARD PLANK name="Hurumm"
	BOARD GET ON name="Flero"
	PLANK name="Huraka"
	DEFEND name="Laparwa"
	DEFENSE name="Onanarwa"
	DIKE name="Mosa"
	PALISADE name="Hubunyuch"
	POST name="Husan"
	RAMPART name="Hurakabe"
	STAKE name="Huruge"
	STOP name="Gaemm"
	STOCKADE name="Hurisoda"
	ABYSS name="Gona"
	CHASM name="Luka"
	CREVICE name="Kallorwe"
	RIFT name="Grina"
	FISSURE name="Lallopes"
	UNDER name="Kedamm"
	ABYSMAL name="Robome"
	SUBMERGE name="Kagundut"
	CYCLONE name="Gistada"
	TYPHOON name="Flenye"
	HURRICANE name="Kolladunye"
	GALE name="Ogada"
	TORNADO name="Gisonada"
	HAIL GREET name="Mully"
	HAIL ICE name="Oston"
	HALE name="Jora"
	ROBUST name="Kondara"
	HARDY name="Jera"
	VIGOR name="Harara"
	AIR name="Lage"
	SPLASH name="Grawlut"
	DABBLE name="Ostulla"
	DOUSE name="Flella"
	DRENCH name="Karut"
	MOIST name="Ragut"
	PLUNGE name="Gadet"
	SHOWER name="Kenduba"
	SLOP name="Gede"
	SLOSH name="Jarwut"
	SOAK name="Marut"
	SPATTER name="Gusully"
	SPLATTER name="Orallada"
	SPRAY name="Hogut"
	SPREAD name="Orees"
	SPRINKLE name="Miwlara"
	TWINKLE name="Humares"
	SQUIRT name="Fliega"
	WAD name="Eav"
	WADE name="Hawla"
	WET name="Gade"
	FADE name="Rolla"
	COLORLESS name="Keegaremm"
	BLANCH name="Jurella"
	BLEACH name="Lubulla"
	BLENCH name="Gesulla"
	FLINCH name="Keruda"
	APPEAR name="Hanade"
	DISAPPEAR name="Kiranarulla"
	DISSOLVE name="Magarulla"
	DULL name="Gilla"
	EVAPORATE name="Pukarurulla"
	LUSTER name="Husoros"
	TONE name="Kisa"
	VANISH name="Meballa"
	WASH name="Grut"
	ABATE name="Orulla"
	DECLINE name="Jellalla"
	DETERIORATE name="Gekorewlulla"
	DIMINISH name="Gomokulla"
	DISPERSE name="Hasusulla"
	DROOP name="Flolle"
	DWINDLE name="Ondabume"
	KINDLE name="Kenalla"
	STOKE name="Okukuv"
	POKE name="Maros"
	STIR name="Kega"
	FEED name="Fleba"
	FAIL name="Kawle"
	LANGUISH name="Kadella"
	LESSEN name="Rakulla"
	LESSON name="Odanya"
	TEACH name="Hanya"
	MASTERY name="Medura"
	PERISH name="Mumut"
	SHRIVEL name="Gasalla"
	SINK name="Megut"
	TAPER name="Rapan"
	THIN name="Flaer"
	TIRE name="Fluka"
	WANE name="Lowla"
	WEAK name="Gret"
	WILT name="Memm"
	WITHER name="Genolla"
	HONOR name="Gadev"
	ADORE name="Gaemar"
	ADULATE name="Kabare"
	CELEBRATE name="Kasadusta"
	CONFIDENT name="Podomira"
	DEFERENCE name="Kerogustode"
	DEITY name="Giwle"
	DISTINCT name="Gradaror"
	ELEVATE name="Kogullan"
	ESTEEM name="Hiegura"
	EXALT name="Honall"
	FAME name="Pora"
	FEALTY name="Piega"
	HOMAGE name="Jamolle"
	MORTAL name="Mandura"
	IMMORTAL name="Korobav"
	LAUD name="Kadga"
	OBEISANCE name="Hudganyos"
	PRAISE name="Eanerin"
	PRESTIGE name="Fleellira"
	RENOWN name="Hepanda"
	REPUTATION name="Grewlagaro"
	TRIBUTE name="Kawlinon"
	WORSHIP name="Geellupa"
	CHASTITY name="Strarawle"
	COURAGE name="Orallora"
	DECENT name="Karedev"
	GOOD name="Kupev"
	INNOCENT name="Madollema"
	MODEST name="Mapoll"
	PRINCIPLE name="Kerarurwega"
	PURE name="Humev"
	RIGHTEOUSNESS name="Gawludanyawle"
	TRUTH name="Eadgev"
	TRUTHFUL name="Hiburev"
	VIRGIN name="Kenyure"
	VIRGINITY name="Pudararolla"
	HOLD name="Miwla"
	SCALD name="Eabada"
	SCALE VERB name="Gebera"
	SCALE SKIN name="Lienye"
	CLAN name="Gaste"
	LABYRINTH name="Heragirwa"
	MAZE name="Gena"
	WEB name="Mide"
	CROWD name="Raror"
	FAMILY name="Gabaka"
	KIN name="Gares"
	MOB name="Grada"
	ORGAN name="Kuramm"
	ORGANIZE name="Gorekanye"
	MESH name="Orana"
	TANGLE name="Midesta"
	ENTANGLE name="Flumuwle"
	PUZZLE name="Hererat"
	PERPLEX name="Herekama"
	QUANDARY name="Herudora"
	COMBINE name="Hellewla"
	FLICKER name="Konunera"
	BRAND name="Karara"
	SINGE name="Flera"
	SEAR name="Odada"
	SCORCH name="Marera"
	ROAST name="Peruda"
	PARCH name="Makura"
	IGNITE name="Kollera"
	INCINERATE name="Pananonesera"
	GLOW name="Omera"
	CREMATE name="Gunirut"
	FACTION name="Hollomm"
	CREW name="Grude"
	VESSEL name="Hurubav"
	LEAGUE GROUP name="Kellusa"
	COOPERATE name="Medodedape"
	GROUP name="Graesa"
	GANG name="Kolly"
	FELLOWSHIP name="Maerarerasa"
	PARTNER name="Gopaka"
	RIDDLE name="Hedenya"
	ROUT name="Jieda"
	SCRAPE name="Gurada"
	SCRAP name="Kewlus"
	SCOUR name="Kagell"
	SCRUB name="Gaelle"
	SHAKE name="Jigura"
	SOAP name="Hurir"
	SPONGE name="Gasulle"
	SWEEP name="Ogulle"
	WHISKER name="Grunanye"
	FASTEN name="Gakura"
	WINNOW name="Granora"
	WIPE name="Geena"
	CLENCH name="Mipora"
	CLINCH name="Gowle"
	CLOUT name="Kamada"
	CLUTCH name="Midaera"
	DOMINATE name="Kadineda"
	DOMINION name="Hokagera"
	GRASP name="Midemm"
	INFLUENCE name="Grullora"
	OWN name="Hinya"
	OWNERSHIP name="Gonawlan"
	TENACITY name="Kanierera"
	BIND name="Midur"
	CARRY name="Geesta"
	CATCH name="Garuv"
	CONFINE name="Midibas"
	CONTAIN name="Midorama"
	CRADLE name="Perwa"
	EMBRACE name="Hundulla"
	POOL name="Gare"
	SOCIETY name="Flobesa"
	CIRCLE name="Maste"
	SQUARE name="Pununye"
	TRIANGLE name="Komusta"
	CONNECT name="Owlendot"
	MERGE name="Mebude"
	CONFUSE name="Hesigone"
	COMPLEX name="Renully"
	MEANDER name="Hierilla"
	MUDDLE name="Kugome"
	BEWILDER name="Heruburun"
	MORASS name="Grarome"
	PROBLEM name="Karaer"
	INTRICATE name="Rudanolla"
	FLUSH name="Gralla"
	MOP name="Kit"
	POLISH name="Kopasta"
	PURGE name="Leella"
	RASP name="Padot"
	RINSE name="Owlada"
	BAND OBJECT name="Puma"
	BAND GROUP name="Jasa"
	TALL name="Kono"
	SHORT name="Monamm"
	BULBOUS name="Hakoma"
	BULB name="More"
	ALLY name="Heena"
	ALLIANCE name="Obobudov"
	ALLEGIANCE name="Mabendaera"
	COALITION name="Masallasa"
	COAL name="Eadan"
	ENJOY name="Gasta"
	FONDLE name="Garara"
	HANDLE OBJECT name="Huroka"
	HANDLE VERB name="Lusta"
	IMPRISON name="Midurage"
	NOURISH name="Kudgarwa"
	SQUEEZE name="Granada"
	TRAMMEL name="Midanera"
	VICE name="Owlav"
	VISE name="Midus"
	DEFECT FAULT name="Owlella"
	PERFECT name="Rasarora"
	GEM name="Gubas"
	JEWEL name="Hobas"
	WIELD name="Geema"
	WRING name="Pudada"
	CONJUNCTION name="Kedgewlenaev"
	BLOT name="Hamm"
	BLOW name="Fluna"
	BRUSH name="Kiere"
	CLARIFY name="Marakuv"
	CLEANSE name="Midgilla"
	DREDGE name="Modome"
	ERASE name="Osulla"
	MORSEL name="Keruran"
	MONGREL name="Kederach"
	TENDER name="Hallamm"
	URGE name="Mumm"
	MECHANISM name="Hurasonus"
	SMEAR name="Hime"
	TATTOO name="Orwumm"
	WEATHER VERB name="Huralla"
	CRUX name="Lende"
	PEEK name="Rare"
	SNEAK name="Herun"
	ATTIC name="Hureso"
	BASEMENT name="Hurunares"
	DEARTH name="Jekas"
	APEX name="Karas"
	NADIR name="Goseme"
	TUNNEL name="Eaguras"
	ENTRANCE VERB name="Kasamuwle"
	DELIGHT name="Killasta"
	JOY name="Husta"
	FRIGID name="Hellome"
	ANKLE name="Hadge"
	ELBOW name="Garore"
	PASSION name="Mamubamm"
	ARDENT name="Ganyida"
	STREAM name="Kadanye"
	BOWEL GUT name="Earupa"
	BOWEL INTERIOR name="Megas"
	DRILL BORE name="Oboda"
	DRILL ROUTINE name="Gumm"
	BORE DRILL name="Muda"
	BOREDOM name="Onosasa"
	FLECK name="Kemas"
	SPOT name="Radga"
	DOT name="Ker"
	CREATE name="Huruda"
	POEM name="Panya"
	POETRY name="Mugella"
	POET name="Henya"
	SCRIBE name="Mapanya"
	MONK name="Gewle"
	HERMIT name="Gunyose"
	RECLUSE name="Horwura"
	 NAME name="Gedge"
	LANGUAGE name="Stroberwa"
	PHRASE name="Kidgera"
	RHYME name="Kidga"
	RHYTHM name="Kupada"
	VERSE name="Kinuko"
	DRUM VERB name="Kida"
	CREATURE name="Kadaranye"
	SNAIL name="Keste"
	VINE name="Randa"
	SQUASH name="Jabada"
	NEVER name="Monira"
	DWELL name="Geelly"
	HABIT name="Opulle"
	CHEW name="Mach"
	SWALLOW name="Merill"
	DISEMBOWEL name="Makedirada"
	EVISCERATE name="Strureruda"
	RAPID name="Mikera"
	MEDICINE name="Kenanarwa"
	HEAL name="Porwa"
	SELL name="Jeech"
	MARKET name="Ladeech"
	SLOW name="Reba"
	MIRE name="Gowla"
	ADMIRE name="Gurudat"
	DIRGE name="Hukame"
	LAMENT name="Gropome"
	FUNERAL name="Mabare"
	QUEST name="Lurura"
	ADVENTURE name="Ostinosura"
	MOURN name="Kugeme"
	MORNING name="Pieranye"
	BULWARK name="Gorerwa"
	COSMOS name="Kasav"
	ANGUISH name="Okonya"
	TAUT name="Kepe"
	DEIFY name="Mawle"
	INFAMY name="Kanyet"
	MORTALITY name="Ladowlesa"
	IMMORTALITY name="Garallawle"
	MORTIFY name="Kodgoch"
	OBEY name="Meren"
	WORSHIPPER name="Gallakawle"
	RIDDLE HOLES name="Rarwada"
	DWELLING name="Maeronye"
	DISEMBOWELMENT name="Gridenyemabadgada"
	EVISCERATION name="Muranosunaeda"
	HEALING name="Garirwa"
	ADMIRATION name="Kagurirolly"
	CONFLICT name="Manibada"
	ATTACK name="Pemade"
	ONSLAUGHT name="Kasanade"
	TREE name="Meeba"
	AMBER name="Heber"
	AMETHYST name="Kabarer"
	AQUA name="Haber"
	AQUAMARINE name="Kedaropella"
	GRAY name="Oker"
	AUBURN name="Haner"
	AZURE name="Gadger"
	BEIGE name="Huller"
	BRASS name="Oner"
	BROWN name="Laller"
	BUFF name="Girer"
	SIENNA name="Haker"
	UMBER name="Flarer"
	CARDINAL_COLOR name="Karaeller"
	CARMINE name="Kaneeder"
	CERULEAN name="Purunolla"
	CHARCOAL name="Gabaener"
	CHARTREUSE name="Grerarabuber"
	CHESTNUT name="Hepunuber"
	CHOCOLATE name="Kebemorus"
	CINNAMON name="Kuballe"
	COBALT name="Ruser"
	INDIGO name="Heller"
	OLIVE name="Earero"
	PINK name="Gaber"
	SCARLET name="Wryniper"
	TAN name="Oger"
	ECRU name="Maber"
	EMERALD name="Puraber"
	FLAX name="Moder"
	FUCHSIA name="Ganolla"
	GOLDENROD name="Strewlaeger"
	HELIOTROPE name="Grabadenye"
	LAVENDER name="Gununalla"
	BLUSH name="Magamm"
	LEMON name="Gustan"
	LILAC name="Meller"
	LIME name="Owler"
	MAHOGANY name="Koneraber"
	MAROON_COLOR name="Gureder"
	MAUVE name="Hawler"
	TAUPE name="Hober"
	MINT name="Geber"
	MOSS name="Keber"
	OCHRE name="Muber"
	ORANGE name="Earerwe"
	PERIWINKLE name="Jaerironenye"
	PLUM name="Kuber"
	PUCE name="Hoker"
	PUMPKIN name="Kanille"
	RUSSET name="Gageser"
	SAFFRON name="Kunalla"
	SEPIA name="Greber"
	TEAL name="Kaner"
	TURQUOISE name="Eadagemm"
	VERMILION name="Hananonder"
	PATH name="Munas"
	THREAT name="Gallame"
	WARNING name="Madame"
	FATE name="Hasav"
	DESTINY name="Muruwlav"
	HORROR name="Kullume"
	LITTLE name="Kewlach"
	EARLY name="Gesas"
	LATE name="Hiren"
	LIFE name="Owla"
	CHEESE name="Onyalle"
	FIGURE_OBJECT name="Huroges"
	HOPE name="Garev"
	BODY name="Maema"
	WALK name="Habat"
	HOUR name="Holl"
	SIT name="Lov"
	MOMENT name="Hapunda"
	BEAUTY name="Jogamm"
	JUDGE name="Gedara"
	WISH name="Horwo"
	RESPECT name="Lawlille"
	MARK name="Kakav"
	HEAVY name="Hosa"
	TRIAL name="Lokome"
	PRACTICE name="Gaballa"

FLOWERY = -Olla
NATURE = -Anye
PRIMITIVE = -Rar
HOLY = -Ewle
EVIL = -Rall
NEGATOR = -Ulla
MAGIC = Pand-
VIOLENT = -Ada
PEACE = Onu-
UGLY = Howl-
DEATH = -Llut
OLD = -Ane
SUBORDINATE = Kewl-
LEADER = Kar-
NEW = -Pas
DOMESTIC = -Ulle
MYTHIC = -Wlav
ARTIFICE = Hur-
COLOR = -Ber
MYSTERY = Her-
NEGATIVE = -Ome
ROMANTIC = -Gamm
ASSERTIVE = -Ura
AQUATIC = -Gut
PROTECT = -Arwa
RESTRAIN = Mid-
THOUGHT = -Anya
WILD = -Llech
 NAME_SWAMP = -Aewla
 NAME_DESERT = -Nder
 NAME_FOREST = Jug-
 NAME_MOUNTAINS = -Ema
 NAME_OCEAN = Giep-
 NAME_GLACIER = -Sach
 NAME_TUNDRA = -Rav
 NAME_GRASSLAND = -Una
 NAME_HILLS = Gab-
 NAME_REGION = Ore-
 NAME_CAVE = Rag-
EARTH = Eade-
 NAME_LAKE = -Adga
 NAME_ENTITY_KINGDOM = Easo-
 NAME_ENTITY_TOWN_FOUNDER = -Asa
GOOD = -Rwev
 NAME_CONTINENT = -Much
 NAME_ISLAND = Pag-
 NAME_ISLAND_SMALL = Griedg-
 NAME_PEAK = -Bus
 NAME_VOLCANO = Flor-
 NAME_COMMON_RELIGION = -Kit
BALANCE = Oge-
BOUNDARY = -Nan
DANCE = Kup-
DARKNESS = Gor-
LIGHT = Hus-
ORDER = -Unye
FESTIVAL = -Usta
FAMILY = Gawl-
FIRE = -Era
FOOD = Eari-
FREEDOM = Kowl-
GAMES = -Uge
LUCK = -Don
MUSIC = Kidg-
SKY = Liell-
SILENCE = -Lliv
TRADE = -Ndeech
TRAVEL = Hall-
TRUTH = -Uga
WEALTH = -Das
 NAME_BUILDING_TEMPLE = -Bev
 NAME_BUILDING_KEEP = Pen-
 NAME_WAR = Jar-
 NAME_BATTLE = -Naech
 NAME_SIEGE = -Ade
 NAME_ROAD = Mest-
 NAME_TUNNEL = -Nas
 NAME_BRIDGE = Roll-
 NAME_WALL = Jos-
 NAME_BUILDING_TOMB = Kor-
24549 Rejected Words
Intended Word Length 0.98 Times Longer Than Normal
Forced Maximum Word Length 0 Letters Longer Than Normal
