Language_ANCIENT XING
Mudora,Kaepora,Madas,Eagus,Owlan,Horwell,Henya,Gully,Greba,Goselle,Gondo,Fledge,Jakamar,Karane,Keet,Kina,Luv,Orielle,Mallara,Rusta,Wryna,Strich,Pumm,Vong,Phong,Singh,Syha,Chan,Dao,Dara,Pha,Phra,Kham,Racha,Rasa,Savane,Phou,Sri,Keo,Vora,Chai
[OBJECT:LANGUAGE]

[TRANSLATION:ANCIENT XING]
	CLASP name="Kares"
	CLAW name="Osa"
	CLEAR name="Marai"
	CLEARING name="Marona"
	CLEAVE name="Cherwa"
	CLING name="Hawla"
	CLOAK name="Jabam"
	CLOBBER name="Hustesa"
	CLOCK name="Sull"
	CLOD name="Gasa"
	CLOISTER name="Gorapon"
	CLOSET name="Donull"
	CLUB name="Rada"
	CLUSTER name="Wrynare"
	CLUTTER name="Kebawla"
	COBRA name="Ranan"
	COIL name="Rewla"
	COLD name="Rawla"
	COLOR name="Koda"
	COMET name="Kavan"
	CONQUEROR name="Ranapung"
	COOK name="Kane"
	COVER name="Sonos"
	COTTON name="Mosasa"
	COUPLE name="Mosoll"
	CRAB name="Gusa"
	CRAWL name="Vorai"
	CRAZE name="Seba"
	CRAZY name="Serwa"
	CREAM name="Kunda"
	CREEK name="Mona"
	CREEP name="Gorai"
	CREEPY name="Vawla"
	CRESCENT name="Phodone"
	CROSS_NOUN name="Olla"
	CROSS_VERB name="Gawla"
	CROSS_ADJ name="Kiwla"
	CROW name="Godum"
	CROWN name="Kerar"
	CRUCIFY name="Vabawla"
	CRUMBLE name="Grirape"
	CRUSH name="Horwa"
	CRUSHER name="Gorasun"
	CRY name="Kima"
	CRYPT name="Gasi"
	CRYSTAL name="Kavun"
	CUDDLE name="Mosire"
	CUDGEL name="Mepesa"
	CUP name="Phana"
	CURSE name="Lello"
	CUT name="Ranum"
	CYST name="Sramm"
	DANCE name="Mosai"
	DANGLE name="Srolla"
	DANK name="Puda"
	DAGGER name="Ranora"
	DARK name="Mada"
	DATE_FRUIT name="Kaba"
	DATE_VERB name="Mosin"
	DAWN name="Mara"
	DAY name="Marat"
	DEAD name="Kusi"
	DEAR name="Mosam"
	DEATH name="Orasi"
	DECAY name="Okona"
	DECEIVER name="Jabugare"
	DEEP name="Kada"
	DEER name="Goset"
	DEMON name="Lenis"
	DESPAIR name="Kurawla"
	DESTROYER name="Goroporwa"
	DESTRUCTION name="Ranuninusto"
	DEVIL name="Chara"
	DEVOURER name="Ranamena"
	DINE name="Phare"
	DINNER name="Karara"
	DIRT name="Phasi"
	DITCH name="Hiwla"
	DOG name="Verai"
	DOMESTIC name="Repara"
	DONKEY name="Phadge"
	DOOM name="Kasi"
	DOOR name="Hull"
	DRAGON name="Radar"
	DRAIN name="Owla"
	DRAWL name="Pawla"
	DREG name="Rerai"
	DRESS_CLOTHING name="Eanda"
	DRESS_GENERAL name="Phan"
	DRINKER name="Lieka"
	DRIP name="Sowla"
	DROOL name="Vosa"
	DROWNED name="Susasi"
	DRUM name="Guveo"
	DRY name="Eawla"
	DUMP name="Lawla"
	DUMPLING name="Chorunda"
	DUNG name="Srang"
	DUNGEON name="Laenull"
	DUSK name="Jacha"
	DUST name="Chasi"
	DUTY name="Phake"
	DYE name="Odull"
	EAGLE name="Sanar"
	EAR name="Regeo"
	EAST name="Khero"
	EAT name="Vorwa"
	ECTO name="Karat"
	EEL name="Gosos"
	EERIE name="Jabev"
	EGG name="Junda"
	ELDER name="Griga"
	ENTRAILS name="Srasenya"
	ETERNAL name="Vadgora"
	EVER name="Kura"
	EVERLASTING name="Gevawlora"
	EVERSEEING name="Mubodgeera"
	EVIL name="Grave"
	EXECUTE name="Povarwa"
	EXECUTIONER name="Ranasurada"
	EYE name="One"
	FACE name="Ras"
	FALL name="Marwa"
	FALSE name="Girwa"
	FAMINE name="Masasi"
	FANG name="Khuga"
	FAT name="Jawla"
	FATAL name="Phosi"
	FATHER name="Kagar"
	FEAR name="Mewla"
	FEAST name="Mangh"
	FETID name="Vasi"
	FIEND name="Lepuv"
	FIERCE name="Ranari"
	FILTH name="Srapo"
	FIN name="Gulle"
	FIND name="Gra"
	FINGER name="Moniso"
	FIRE name="Saros"
	FIRST name="Kugar"
	FISH_ANIMAL name="Gully"
	FISH_VERB name="Guro"
	FIST name="Ranet"
	FLAME name="Meros"
	FLANK name="Sarai"
	FLEA name="Orai"
	FLESH name="Jolly"
	FLING name="Phang"
	FLOOD name="Gulli"
	FLOWER name="Phusev"
	FLUTE name="Haveo"
	FLY_ANIMAL name="Rasi"
	FLY_VERB name="Sera"
	FOCUS name="Villa"
	FOG name="Goser"
	FOOL name="Perai"
	FOOT name="Kena"
	FOREST name="Gradar"
	FORK name="Guwla"
	FORTIFY name="Soneda"
	FORTRESS name="Sonare"
	FRAGILE name="Minirai"
	FRAGMENT name="Merawla"
	FRAME name="Mode"
	FRAY name="Kuwla"
	FREE name="Phoro"
	FRENZY name="Ranot"
	FREEZE name="Rowla"
	FRILL name="Mung"
	FROG name="Gosir"
	FRUIT name="Gosot"
	FUNGUS name="Gosara"
	FUR name="Singh"
	GALL name="Srare"
	GAME name="Larar"
	GARISH name="Kusuv"
	GARLIC name="Kallat"
	GARNISH name="Kallare"
	GATE name="Orull"
	GAUNT name="Ruwla"
	GAZE name="Lige"
	GEAR name="Khull"
	GERBIL name="Gosera"
	GHOST name="Dusi"
	GHOUL name="Mosi"
	GIFT name="Hall"
	GILL name="Gudga"
	GIRDLE name="Kanda"
	GLAND name="Srava"
	GLAZE name="Jaga"
	GLEN name="Mare"
	GLIDE name="Maban"
	GLIMMER name="Konenda"
	GLISTEN name="Srinda"
	GLOSS name="Runda"
	GLOVE name="Sonas"
	GLUTTON name="Phiwla"
	GOAT name="Phade"
	GOD name="Jagar"
	GOD-FORSAKEN name="Lellanopalla"
	GOLD name="Onou"
	GOOSE name="Sriva"
	GORE name="Ovosa"
	GORGE_NOUN name="Jaera"
	GORGE_VERB name="Hamo"
	GRAIN name="Sape"
	GRAND name="Char"
	GRAPE name="Goras"
	GRASS name="Khane"
	GRAVE name="Jiesi"
	GREASE name="Sracha"
	GREAT name="Merar"
	GREED name="Seran"
	GREEN name="Koche"
	GRIFFON name="Sivara"
	GRILL name="Rarwa"
	GRIM name="Muwla"
	GRIND name="Gerwa"
	GRIP name="Dase"
	GRISTLE name="Srasaga"
	GRIZZLE name="Griremm"
	GROVE name="Mang"
	GROW name="Gose"
	GROWL name="Goba"
	GROWTH name="Gosier"
	GRUB name="Gosun"
	GUARD name="Sonan"
	GUILE name="Gowla"
	GUISE name="Jabov"
	GUT name="Srasi"
	GUTTER name="Ranuda"
	HAG name="Grire"
	HAIR name="Ove"
	HAIRY name="Kasa"
	HAME name="Kanes"
	HAMMER name="Sarull"
	HAMMERER name="Rudonull"
	HAND name="Mimm"
	HANDY name="Phapo"
	HARE name="Gorim"
	HARVEST name="Pharova"
	HARVEST_VERB name="Kamedge"
	HATCHET name="Hobuga"
	HATE name="Lelle"
	HAUNT name="Jabat"
	HAWK name="Goso"
	HAY name="Ongh"
	HEAD name="Som"
	HEART name="Srada"
	HEARTH name="Maruri"
	HEATHER name="Maraves"
	HEDGE name="Gosi"
	HELL name="Ogumm"
	HELM name="Hovas"
	HERO name="Hadar"
	HEX name="Kavai"
	HIDE name="Disa"
	HIDEOUS name="Sragena"
	HIGH name="Gerar"
	HILL name="Vaba"
	HIP name="Pham"
	HOARY name="Gore"
	HOBBLE name="Merai"
	HOG name="Goson"
	HOLY name="Gora"
	HOIST name="Gumm"
	HOLE name="Pada"
	HOME name="Jella"
	HONEY name="Vonda"
	HOOD name="Jabon"
	HOOF name="Gosem"
	HOP_NOUN name="Grara"
	HOP_VERB name="Gosen"
	HORN name="Rasta"
	HORSE name="Phama"
	HOUND name="Phach"
	HOWL name="Serwe"
	HUG name="Mosa"
	HUM name="Raveo"
	HUNGER name="Mowla"
	HUSTLE name="Saewla"
	ICE name="Rarou"
	IDLE name="Parai"
	IDOL name="Pagar"
	ILL name="Diwla"
	IMPURE name="Okawla"
	INCENSE name="Vadanda"
	INCH name="Syhe"
	INK name="Och"
	INN name="Khera"
	INSANITY name="Menowla"
	INVISIBLE name="Jabachada"
	IRON name="Konou"
	ITCH name="Sraba"
	IVY name="Grira"
	JACK name="Seng"
	JACKAL name="Gonye"
	JAUNDICE name="Srasano"
	JAW name="Khasa"
	JEST name="Dus"
	JOKE name="Rires"
	JUGGLE name="Pharet"
	JUICE name="Srage"
	JUNGLE name="Powlar"
	JUST name="Phaba"
	JUSTIFY name="Vagas"
	KEEPER name="Socho"
	KEG name="Rull"
	KEY name="Gull"
	KINDNESS name="Marane"
	KILLER name="Ranere"
	KISS name="Morwa"
	KING name="Dogar"
	KNEAD name="Gavou"
	KNIFE name="Ranov"
	KNIGHT name="Phawla"
	KNIT name="Punda"
	KNOT name="Jabe"
	LACE name="Munda"
	LAKE name="Gorao"
	LARD name="Riva"
	LARK name="Goses"
	LARVA name="Gong"
	LAST name="Jabum"
	LAW name="Sona"
	LAZY name="Duwla"
	LEADER name="Orarar"
	LEAF name="Gorun"
	LEAK name="Harai"
	LEAN name="Khana"
	LEECH name="Garai"
	LEGEND name="Husara"
	LENS name="Chull"
	LEOPARD name="Gosane"
	LEPER name="Luwla"
	LEPROSY name="Srasara"
	LETTER name="Kunull"
	LIE name="Jabur"
	LIGHT name="Chove"
	LIGHTNING name="Senakaron"
	LIMB name="Pha"
	LIP name="Dona"
	LISTEN name="Rogull"
	LIZARD name="Gosege"
	LOBSTER name="Guman"
	LOCK name="Phou"
	LONE name="Hulla"
	LONG name="Sara"
	LOOT name="Para"
	LORD name="Vabar"
	LOST name="Jalle"
	LOUSE name="Srana"
	LOVE name="Somus"
	LOW name="Kerai"
	LUNCH name="Kallo"
	LUNG name="Flase"
	LURID name="Srabo"
	LURCH name="Howla"
	LURK name="Jabo"
	LUSH name="Gosav"
	LUST name="Monya"
	LUTE name="Manda"
	LYRIC name="Maveo"
	MAGGOT name="Gosape"
	MAGIC name="Kabov"
	MAN name="Chade"
	MANGE name="Sudgi"
	MANY name="Cheo"
	MARSH name="Pirav"
	MARTYR name="Goreo"
	MASTER name="Hugar"
	MAW name="Radin"
	MEAD name="Kaes"
	MEADOW name="Donda"
	MEAL_DOM name="Kall"
	MEAL_GROUND name="Rorwa"
	MEAT name="Sraro"
	MEDITATION name="Makanadera"
	MELLOW name="Marora"
	MENACE name="Korara"
	MESS name="Sewla"
	METAL name="Rinda"
	MIDNIGHT name="Lelledas"
	MIGHTY name="Phapam"
	MIGHTINESS name="Seranodar"
	MILE name="Flar"
	MINCE name="Kurwa"
	MIND name="Vasa"
	MINION name="Murai"
	MIRROR name="Jabara"
	MISERY name="Phuwla"
	MIST name="Goseo"
	MITE name="Sran"
	MOLD name="Goge"
	MOLE name="Varai"
	MOLTEN name="Virou"
	MONKEY name="Gosasa"
	MOON name="Vesa"
	MONGER name="Sagesa"
	MOTH name="Gosur"
	MOTHER name="Phulla"
	MOUSE name="Rarai"
	MOUTH name="Khor"
	MUCK name="Rut"
	MUD name="Gerai"
	MUFFIN name="Karasa"
	MULE name="Dare"
	MUNCH name="Rares"
	MURDER name="Karasi"
	MUSH name="Sram"
	MUSHROOM name="Phadgira"
	MUSIC name="Honda"
	MYSTERY name="Jabage"
	MYTH name="Rora"
	NAIL name="Rasa"
	NASTY name="Dewla"
	NATURE name="Gosana"
	NECRO name="Musi"
	NEGATIVE name="Karawla"
	NEGATE name="Onawla"
	NEO name="Justa"
	NEST name="Hida"
	NESTLE name="Vanda"
	NET name="Res"
	NETTLE name="Gosaro"
	NEW name="Jugev"
	NEWT name="Godat"
	NIBBLE name="Srarai"
	NIGHT name="Vesta"
	NIGHTMARE name="Lellawla"
	NOBLE name="Korar"
	NOOSE name="Rirwa"
	NORTH name="Khere"
	NOSE name="Orwus"
	NULL name="Dorwa"
	NUMBER name="Mallou"
	NURTURE name="Sanonda"
	NUT name="Kam"
	OAK name="Gosao"
	OAR name="Phull"
	OAT name="Phase"
	OBLIVION name="Kellura"
	OCEAN name="Grena"
	OLD name="Grise"
	OMEN name="Hora"
	ONE name="Jawlo"
	ONE_PREF name="Che"
	ONION name="Kasus"
	OOZE name="Sraso"
	OPEN name="Phona"
	ORB name="Kaver"
	OVER name="Hesar"
	OWL name="Gosut"
	OX name="Phage"
	PACK name="Phore"
	PAD_NOUN name="Sopa"
	PAD_VERB name="Sonat"
	PAGE name="Srane"
	PAIN name="Hewla"
	PAINT name="Mebi"
	PALE name="Koga"
	PALM name="Kore"
	PANT name="Flasa"
	PANTHER name="Gosabe"
	PANTS name="Pharo"
	PAPER name="Sarao"
	PEACE name="Maron"
	PEACH name="Gona"
	PEPPER name="Senya"
	PHLEGM name="Srasut"
	PIG name="Opa"
	PIT name="Rill"
	PITCH name="Gewla"
	PLAGUE name="Ledera"
	PLANT name="Flera"
	PLANTER name="Gosira"
	PLOT name="Masi"
	POCKET_NOUN name="Sonana"
	POCKET_VERB name="Jabore"
	POISON name="Lellas"
	PORTAL name="Danull"
	POWER name="Poser"
	PRANK name="Seste"
	PREGNANT name="Phoronda"
	PRIDE name="Phari"
	PRIEST name="Goran"
	PRIM name="Konda"
	PRIME name="Kosar"
	PRIMITIVE name="Surunasa"
	PROFANE name="Lellagi"
	PROPHECY name="Daerara"
	PROPHET name="Larara"
	PROWL name="Viwla"
	PUKE name="Hawle"
	PULL name="Kusta"
	PULLEY name="Vonull"
	PULP name="Sras"
	PUNCH name="Rang"
	PURPLE name="Kochut"
	PUS name="Heva"
	PUTRID name="Vorosi"
	QUAKE name="Junou"
	QUEEN name="Onda"
	QUICK name="Hasta"
	QUILL name="Chou"
	RABBIT name="Gosere"
	RABBLE name="Grewla"
	RACE_GROUP name="Mat"
	RACE_VERB name="Vokou"
	RACK name="Onosi"
	RAG name="Phisa"
	RAGE name="Karos"
	RAIN name="Sepou"
	RAKE name="Rava"
	RAM name="Gosam"
	RAMPAGE name="Dipawla"
	RANDOM name="Fliwla"
	RANSACK name="Ranerom"
	RAPTOR name="Gosapa"
	RAT name="Golle"
	RAUNCH name="Srasam"
	RAVAGER name="Rananor"
	RAVEN name="Gove"
	RAW name="Jasa"
	RAZOR name="Hobus"
	RED name="Mosum"
	REGAL name="Mugar"
	REIGN name="Grar"
	REIN name="Karar"
	REND name="Raneo"
	RIDER name="Lobet"
	RIM name="Flull"
	RING_OBJECT name="Kavom"
	RING_SOUND name="Riveo"
	RIP name="Jorwa"
	RIPE name="Gonai"
	RIPPER name="Flarwa"
	RISE name="Chaen"
	RITE name="Kavon"
	RIVER name="Guran"
	ROCK name="Hobo"
	ROGUE name="Jabav"
	ROMANCE name="Mosukan"
	ROOM name="Pull"
	ROOMY name="Lull"
	ROOT name="Gosou"
	ROSE name="Mosan"
	ROT name="Jasi"
	ROUGH name="Grull"
	ROYAL name="Magar"
	RUIN name="Golla"
	RUIN_V name="Sarwa"
	RULER name="Kovar"
	RUMOR name="Jaban"
	RUST name="Grisa"
	SABRE name="Ranom"
	SACK name="Grosa"
	SAINT name="Somi"
	SALT name="Phas"
	SALVE name="Gonav"
	SAP name="Gosor"
	SATIN name="Sanda"
	SAVAGE name="Eabusa"
	SAVAGERY name="Raniron"
	SAVIOR name="Somane"
	SCAB name="Raba"
	SCAR name="Leda"
	SCOLD name="Ranuv"
	SCORPION name="Gosesto"
	SCRATCH name="Ranebi"
	SCOURGE name="Ranacha"
	SCREAM name="Ranara"
	SCUM name="Komeo"
	SEA name="Grera"
	SEAL_ANIMAL name="Gosin"
	SEAL_ART name="Kavat"
	SEAM name="Gaba"
	SEASON name="Gososa"
	SECRET name="Jabora"
	SEDUCE name="Ledara"
	SEDUCER name="Seras"
	SEED name="Gopa"
	SEER name="Kava"
	SEIZE name="Ranev"
	SERPENT name="Ladowla"
	SERVANT name="Jaserai"
	SEVER name="Ranon"
	SEWER name="Reda"
	SHADOW name="Manada"
	SHAFT name="Obada"
	SHANK name="Piere"
	SHARK name="Syho"
	SHEAR name="Ralla"
	SHEEN name="Handa"
	SHELL name="Sonen"
	SHELTER name="Ganull"
	SHIELD name="Sanull"
	SHIMMER name="Kavire"
	SHIP name="Osull"
	SHOOT name="Ranao"
	SHOW name="Danda"
	SHRED name="Rano"
	SHRIEK name="Serwes"
	SHUT name="Vowla"
	SICK name="Pusi"
	SICKNESS name="Gaewla"
	SIEGE name="Mures"
	SILENCE name="Mades"
	SILK name="Mose"
	SILKY name="Hunda"
	SILT name="Hurai"
	SILVER name="Serama"
	SIN name="Lera"
	SINEW name="Sana"
	SING name="Dinda"
	SISTER name="Hobena"
	SKIRT_CLOTHING name="Sunda"
	SKIRT_VERB name="Dunda"
	SKUNK name="Gosus"
	SKULL name="Grasi"
	SKY name="Sena"
	SLAUGHTER name="Ranamanye"
	SLAVE name="Larai"
	SLAYER name="Purwa"
	SLIM name="Giwla"
	SLIME name="Karai"
	SLING name="Obull"
	SLINK name="Rorai"
	SLIT name="Siwla"
	SLITHER name="Denerai"
	SLIVER name="Oduwla"
	SLOTH name="Pewla"
	SLUG name="Virai"
	SMASH name="Merwa"
	SMILE name="Genda"
	SMITH name="Okull"
	SMOKE name="Jabao"
	SMOOTH name="Kella"
	SMOULDER name="Sirowla"
	SNACK name="Kadar"
	SNAKE name="Goren"
	SNEER name="Jowla"
	SNOT name="Strus"
	SNUGGLE name="Mosipur"
	SOIL name="Horai"
	SOLDIER name="Rawludo"
	SOOT name="Riwla"
	SOOTHE name="Modou"
	SORROW name="Viewla"
	SOUL name="Kara"
	SOUND name="Mulle"
	SOUTH name="Khene"
	SPASM name="Vewla"
	SPAWN name="Jurai"
	SPEAR name="Ranis"
	SPELL name="Kave"
	SPICE name="Dura"
	SPIDER name="Lellam"
	SPIDERY name="Gosenda"
	SPIKE name="Ranou"
	SPIN name="Grora"
	SPINE name="Monom"
	SPIRIT name="Pollou"
	SPIT name="Mamm"
	SPITTLE name="Srasung"
	SPOIL name="Lurwa"
	SPOON name="Kuva"
	SPRING_NOUN name="Srull"
	SPRING_SEASON name="Junde"
	SPRING_VERB name="Phadga"
	SPRY name="Jundi"
	SPY name="Jabin"
	SQUID name="Gullo"
	SQUIRM name="Pharai"
	STAB name="Ranir"
	STAFF name="Kavao"
	STALK name="Jabus"
	STAND name="Kire"
	STAR name="Senas"
	STEED name="Phame"
	STARVE name="Kagaen"
	STEAL name="Chall"
	STEEL name="Ronou"
	STENCH name="Srasom"
	STERN name="Kham"
	STICK_WOOD name="Gope"
	STICK_VERB name="Rally"
	STICKY name="Chawla"
	STONE name="Orasa"
	STORM name="Raras"
	STRANGE name="Miruwla"
	STRAP name="Dasa"
	STRAPPING_ADJ name="Jundonaga"
	STRAW name="Gosiv"
	STRAY name="Serwo"
	STRENGTH name="Phapadeo"
	STRETCH name="Daewla"
	STRIKE name="Ranipa"
	STROKE name="Syhava"
	STUNT name="Jarai"
	STUNTED name="Kanarai"
	STUPID name="Liwla"
	STUTTER name="Orowla"
	STYLE name="Vunda"
	SUBORDINATE name="Kadoruberai"
	SUCK name="Kare"
	SUFFERING name="Kurabawla"
	SUGAR name="Karas"
	SULLY name="Sradi"
	SULLEN name="Sodeo"
	SUMMER name="Gosura"
	SUN name="Choka"
	SUNDER name="Ranapa"
	SUPPER name="Kasen"
	SURPRISE name="Sendulla"
	SWAMP name="Pira"
	SWEAT name="Dorar"
	SWEET name="Kinda"
	SWIFT name="Recha"
	SWIM name="Gupa"
	SWINE name="Phane"
	SWORD name="Radga"
	SYRUP name="Kanya"
	TAKER name="Jana"
	TAIL name="Gosev"
	TALON name="Ranun"
	TAR name="Vuwla"
	TARNISH name="Kamuwla"
	TELL name="Hagao"
	TEMPEST name="Gosache"
	TEAR name="Juwla"
	TERROR name="Lekana"
	THIEF name="Jane"
	THIRST name="Jiwla"
	THORN name="Ranav"
	THRALL name="Orawla"
	THREE name="Kung"
	THROAT name="Gadgo"
	THRONE name="Janar"
	THROWER name="Ranase"
	THUNDER name="Senonut"
	TICK_ANIMAL name="Goror"
	TICK_CLOCK name="Duste"
	TIGHT name="Keena"
	TIME name="Grina"
	TOAD name="Herai"
	TOE name="Stro"
	TOMB name="Vase"
	TOME name="Grive"
	TONGUE name="Karot"
	TOOTH name="Giesa"
	TORMENT name="Ranira"
	TOUCH name="Grere"
	TOUCHY name="Lewla"
	TOUR name="Phon"
	TOWER name="Jenam"
	TRAIL name="Khun"
	TRANCE name="Kavoga"
	TRAP name="Powla"
	TRASH name="Miwla"
	TREASURE name="Senomeko"
	TREAT name="Phav"
	TREATY name="Dorull"
	TRENCH name="Chikar"
	TRIBE name="Odasa"
	TRICK name="Jabot"
	TRICKERY name="Jabunada"
	TRIM name="Denda"
	TROUBLE name="Kosawla"
	TUG name="Ovas"
	TULIP name="Hinda"
	TUMBLE name="Osawla"
	TUMOR name="Dasi"
	TURMOIL name="Harowla"
	TUSK name="Hobav"
	TWEET name="Gunda"
	TWILIGHT name="Gomowla"
	TWINE name="Chomm"
	TWIST name="Dongh"
	TWO name="Kusa"
	UGLY name="Srabe"
	ULCER name="Kewla"
	ULTIMATE name="Garugar"
	ULTRA name="Vagar"
	UNBRIDLED name="Serwodasa"
	UNCLE name="Valla"
	UNGODLY name="Lellaba"
	UNHOLY name="Lellan"
	UNKEMPT name="Serwien"
	UNSEEN name="Jadana"
	UNTOWARD name="Khabawla"
	UNWELCOME name="Ranarawla"
	URN name="Khasi"
	USELESS name="Purorai"
	VANDAL name="Ranare"
	VEGETABLE name="Karobowla"
	VEGETATE name="Gasawla"
	VEGETATION name="Gosenugore"
	VELVET name="Phanda"
	VENOM name="Sasi"
	VERMIN name="Srarav"
	VILE name="Ganda"
	VIOLATOR name="Raneeran"
	VIOLENCE name="Ranuruch"
	VIOLET name="Kochin"
	VIPER name="Gorur"
	VOICE name="Kevat"
	VOID name="Desi"
	VOLCANO name="Gadasos"
	VOMIT name="Mova"
	VULTURE name="Viedasi"
	WAIL name="Flena"
	WANDER name="Sedena"
	WAR name="Eacha"
	WARRIOR name="Randach"
	WASP name="Goma"
	WASTE name="Garas"
	WATCH name="Gina"
	WATCHFUL name="Ollellou"
	WAVE name="Gubi"
	WAVY name="Ronda"
	WEAR name="Puwla"
	WEASEL name="Srorai"
	WEAVER name="Panya"
	WEED name="Suwla"
	WEIGHT name="Eally"
	WEIRD name="Huwla"
	WERE name="Vavan"
	WEST name="Khell"
	WHEAT name="Gomat"
	WHEEL name="Kheri"
	WHIP name="Ranus"
	WHISK name="Siet"
	WHISKY name="Lurana"
	WHISPER name="Jabocha"
	WHITE name="Karem"
	WICKED name="Lellav"
	WILD name="Serwi"
	WILL name="Khai"
	WING name="Gongh"
	WINTER name="Gasama"
	WISP name="Lenda"
	WITCH name="Kavuv"
	WONDER_NOUN name="Mumara"
	WONDER_VERB name="Rallou"
	WOOD name="Govo"
	WORK name="Mas"
	WORM name="Kosi"
	WRAITH name="Earasi"
	WRATH name="Ranen"
	WRETCH name="Kherai"
	YARN name="Phall"
	YEAR name="Grin"
	YEARLING name="Jundolli"
	YELLOW name="Kochan"
	YOR name="Griki"
	YOUNG name="Jundo"
	YOUTH name="Jully"
	ZEAL name="Surao"
	ZEALOT name="Monaka"
	ZEPHYR name="Serwov"
	EARTH name="Jonou"
	ARTIFACT name="Grarull"
	BED name="Phaso"
	BUD name="Juva"
	CAVORT name="Kusare"
	COMMON name="Rirat"
	DAUB name="Jaev"
	DESERT name="Onoras"
	DESSERT name="Kurunda"
	DIAMOND name="Seraka"
	DOMAIN name="Vasida"
	DREAM name="Jaben"
	TIN name="Manou"
	COPPER name="Oranou"
	BRONZE name="Chonou"
	GRANITE name="Rerinou"
	FANCY name="Venda"
	FARM name="Phano"
	FIELD name="Riesa"
	FROTH name="Sesir"
	GENIUS name="Kavang"
	GLACIER name="Gosang"
	GURGLE name="Srasat"
	IMPALE name="Ranida"
	JOIN name="Kolly"
	JADE name="Serar"
	IVORY name="Serav"
	LAND name="Vung"
	LATHER name="Grunda"
	LIMP name="Lirai"
	LUCID name="Donen"
	MOUNTAIN name="Dodinou"
	MUCUS name="Kona"
	PATTERN name="Kubade"
	PEBBLE name="Ganou"
	BOULDER name="Vudanou"
	PETAL name="Janda"
	DROPLET name="Raranda"
	PINNACLE name="Hobarema"
	PLAIN name="Jusa"
	PLAINADJ name="Phesa"
	POINT name="Monao"
	POT name="Ganom"
	PRAIRIE name="Gosema"
	RUSH name="Vage"
	SLAP name="Vaeva"
	SLEEVE name="Rorull"
	SPECK name="Serai"
	STEPPE name="Phosa"
	TENTACLE name="Gosapun"
	TEST name="Kude"
	TROT name="Kame"
	TUB name="Radav"
	TUBE name="Pora"
	TUNDRA name="Gosoro"
	UN name="Orwa"
	WADDLE name="Gruwla"
	WEALTH name="Seros"
	WEEVIL name="Gosada"
	WHIM name="Chana"
	WHIRL name="Selle"
	WORLD name="Varav"
	DESERTVERB name="Gurwa"
	FANCYVERB name="Moses"
	LIMPVERB name="Jerai"
	POINTVERB name="Dora"
	PANTOMIME name="Phroranda"
	SLUDGE name="Pirara"
	GOO name="Pire"
	REALM name="Vara"
	PLANE name="Varit"
	DIMENSION name="Varobiche"
	UNIVERSE name="Varokesa"
	PLANET name="Varona"
	LIVID name="Senav"
	TEPID name="Davao"
	HONEST name="Hanech"
	KINGDOM name="Duraem"
	EMPIRE name="Repaem"
	CONFEDERATION name="Orolluwladaem"
	SIMPLE name="Rirasa"
	TROOPER name="Varerai"
	CRIMSON name="Kocham"
	DUNE name="Ronas"
	DIRECT name="Phapar"
	CLASH name="Gake"
	FOREVER name="Morora"
	SUBTLE name="Jababe"
	PUPPET name="Orwull"
	HEGEMON name="Odarar"
	AMAZE name="Varem"
	ALCHEMY name="Kavona"
	INSIGHT name="Khallou"
	UNION name="Kaem"
	CONFEDERACY name="Phrarudgaem"
	SPEAK name="Sang"
	SPEAKER name="Sanyoda"
	PERSUADE name="Phaparir"
	PERSUADER name="Phapapong"
	CONTROL name="Gravede"
	CONTROLLER name="Kodgabode"
	WORKER name="Korat"
	BASIC name="Hovon"
	SYSTEM name="Phrade"
	RAY name="Veeng"
	TARGET name="Raneba"
	BANK name="Keruv"
	CLEAN name="Julla"
	DRIVE name="Gode"
	SOAR name="Srera"
	GLORY name="Kullo"
	DISMAL name="Mirwa"
	RADIANCE name="Phaparat"
	PINE name="Gosim"
	MESSIAH name="Vabakar"
	CRAFT name="Sado"
	LABOR name="Huba"
	DISCOVER name="Phidase"
	PROLIFERATE name="Kollomaeran"
	CHUNK name="Porai"
	SLIP name="Javao"
	SLIDE name="Srore"
	SINGLE name="Manana"
	PICK name="Chem"
	TONGS name="Eang"
	PERMANENCY name="Griravirao"
	RESPONSIBLE name="Gellellawla"
	REQUIRE name="Charam"
	ROOTVERB name="Gan"
	BLIZZARD name="Raresao"
	GENERAL name="Hadogar"
	MEMORY name="Cherwe"
	CONSTRUCT name="Lerenull"
	LAMB name="Derai"
	TOAST name="Khav"
	GROSS name="Srall"
	PADDLE name="Ginull"
	COUNCIL name="Pharara"
	COUNSEL name="Kipan"
	GNARLED name="Gosubao"
	STUMP name="Parwa"
	NAUGHTY name="Chuwla"
	PLAY FUN name="Lara"
	PLAY PERFORM name="Kuse"
	FLIMSY name="Srawla"
	GREATER name="Phapusa"
	GREATEST name="Vurullar"
	LESSER name="Easage"
	LEAST name="Earai"
	BEARD name="Gosov"
	DREAD name="Rosi"
	WALL name="Monot"
	WALLOW name="Hastav"
	TAX name="Sero"
	FRAGRANCE name="Mollanda"
	LANTERN name="Karwull"
	TORCH name="Rabos"
	WATER name="Gova"
	WINE name="Phum"
	LINE name="Madan"
	MINE name="Renou"
	WAX name="Gosat"
	SHOVE name="Rape"
	SHOVEL name="Opull"
	MELT name="Ranas"
	WRACK name="Rani"
	GLITTER name="Modunda"
	SPARK name="Varou"
	SPARKLE name="Orinda"
	FLASH name="Chon"
	GLEAM name="Chov"
	RUN name="Serut"
	DASH name="Sere"
	SAVANT name="Hellou"
	ROAR name="Easa"
	YELL name="Phabo"
	ECHO name="Guda"
	HOLLOW name="Gumada"
	FULL name="Kou"
	EMPTY name="Porwa"
	WORD name="Darun"
	INTENSE name="Serwaga"
	SAD name="Mally"
	GLAD name="Soma"
	TRAGEDY name="Raronda"
	BELL name="Koveo"
	BELLY name="Kari"
	TUMMY name="Kach"
	SHOCK name="Raseo"
	PONDER name="Marida"
	PONDEROUS name="Srellaka"
	HEAVEN name="Sepama"
	ROUND name="Rarwe"
	ROUNDED name="Orolla"
	UNSPEAKABLE name="Jabasarara"
	UNTHINKABLE name="Jaburosi"
	UNNAMEABLE name="Gadgorera"
	CALAMITY name="Kabuwla"
	CYCLOPEAN name="Paranda"
	TAME name="Rines"
	UNTAMED name="Flokasa"
	BURST name="Lerwa"
	METEOR name="Phapav"
	TRITE name="Lowla"
	TRIFLE name="Oranda"
	RANK name="Vai"
	RANCOR name="Odawla"
	BITTER name="Flirwa"
	SOUR name="Darwa"
	DANGER name="Ranona"
	IMPERVIOUS name="Jabuvarusa"
	UNSWERVING name="Phapamarou"
	SWAY name="Derwa"
	LUXURY name="Seraki"
	EUPHORIA name="Chanunda"
	SCINTILLATE name="Kosogabunda"
	DIVINE name="Gorine"
	DIVIDE name="Chepos"
	TAINT name="Harwa"
	CORRUPT name="Kugawla"
	MALIGN SLANDER V name="Lelluv"
	MALIGN ADJ name="Phewla"
	MALIGNANT name="Magomawla"
	TRUST name="Sova"
	DISTRUST name="Ramawla"
	TRUSTWORTHY name="Rikabech"
	UNTRUSTWORTHY name="Wrynokachawla"
	DISHONEST name="Rapebawla"
	BLIGHT name="Jurwa"
	CUNNING name="Chapam"
	SLY name="Fla"
	RUSTIC name="Desull"
	HOMELY name="Phaneo"
	LONELY name="Opowla"
	LONESOME name="Kaemawla"
	CLOSE name="Song"
	FORD name="Goret"
	WAY name="Dos"
	WAYWARD name="Kheropa"
	BANDIT name="Ranama"
	BRIGAND name="Ranape"
	MONSTER name="Lelline"
	SENSE name="Gide"
	INSENSITIVE name="Strepopuwla"
	SENSUAL name="Ochanda"
	ODOR name="Losta"
	MALODOROUS name="Kinanonda"
	IGNORANT name="Hollerai"
	IGNOBLE name="Momawla"
	HUMBLE name="Maruve"
	MORAL name="Somov"
	IMMORAL name="Harawla"
	SUPERIOR name="Rasogar"
	INFERIOR name="Ledgawla"
	INFINITE name="Kharera"
	SABLE COLOR name="Masta"
	FELL CRUEL name="Legeo"
	FELL HIDE name="Grasa"
	PELT HIDE name="Pasa"
	DIGNITY name="Somunan"
	UNDIGNIFIED name="Chonubawla"
	INDIGNATION name="Phaparidora"
	RIGHT BETTER name="Somir"
	ABSOLUTE name="Kodagar"
	FAIR EVEN name="Earam"
	FAIR COLOR name="Kobas"
	SNARL name="Opasa"
	LOYAL name="Sonus"
	DISLOYAL name="Khavawla"
	HELP name="Someo"
	FRIEND name="Somach"
	COURTESY name="Somiruba"
	CHEERFUL name="Somallan"
	THRIFT name="Phadgo"
	BRAVERY name="Makung"
	REVERE name="Flavan"
	VENERATE name="Gorusaka"
	SALUTE name="Omurai"
	NATION name="Haraem"
	DRINK name="Dalle"
	CONSIDERATE name="Somillarane"
	CONVENIENT name="Phallanoga"
	INCONSIDERATE name="Denanyobawla"
	INCONVENIENT name="Gumenawla"
	CONTINENT name="Morapore"
	FLIGHT name="Goseng"
	FLIGHTY name="Larawla"
	GILD name="Sereo"
	GUILD name="Sagon"
	MERCHANT name="Sandim"
	TRADE name="Sagan"
	PLAIT name="Ramot"
	BRAID name="Hang"
	PLEAT name="Relle"
	FOLD name="Khus"
	BUNION name="Onowla"
	UNCOMMON name="Ogisou"
	RARE name="Hodan"
	SCARCE name="Charwa"
	REMARKABLE name="Lobusar"
	UNREMARKABLE name="Sisosonderai"
	SOLITARY name="Phukundi"
	BEND name="Rache"
	BLAME name="Earwa"
	BLAMELESS name="Somararam"
	TWIG name="Goche"
	GIRDER name="Vipull"
	TRUSS name="Kunes"
	SKEWER name="Durwa"
	SCULPT name="Phapet"
	TRESS name="Kenda"
	LOCK HAIR name="Saba"
	CURL name="Chuna"
	TUFT name="Hasa"
	MEAN NASTY name="Jewla"
	MEAN LOW name="Korai"
	SHAME name="Eavao"
	ASHAMED name="Herawla"
	STEAM name="Ranim"
	FERN name="Golly"
	FERRY name="Daera"
	GULLY name="Gogam"
	WORRY name="Sagou"
	LION name="Kang"
	CACTUS name="Gosona"
	DESK name="Hore"
	BOTTLE name="Ronull"
	SHINGLE name="Kanull"
	BLANKET name="Sonoch"
	CLOUD name="Sene"
	PLATE name="Gira"
	ROAD name="Ondo"
	HOUSE name="Siran"
	BEAN name="Gosom"
	BLOCK DEFEND name="Sone"
	BLOCK SQUARE name="Gally"
	FOUNTAIN name="Momerull"
	PEARL name="Seren"
	PEAR name="Govai"
	THIMBLE name="Vunull"
	BUNNY name="Phat"
	ROPE name="Ode"
	STRING name="Jonull"
	WIRE name="Rupo"
	LASH name="Gem"
	SORCERY name="Kavadi"
	SORCERER name="Kavamora"
	ENSORCEL name="Pallanda"
	BEWITCH name="Kavonis"
	MAGICIAN name="Kavosuba"
	CONJURE name="Kavasa"
	CONJURER name="Kavekuri"
	ENCHANT name="Ondara"
	ENCHANTER name="Kavekakat"
	LANCE name="Ranem"
	LANCER name="Ranena"
	STINK name="Sing"
	FRECKLE name="Syhiga"
	PIMPLE name="Stradi"
	WART name="Hurwa"
	BLOTCH name="Srasus"
	CALLUS name="Srasem"
	WIND STORM name="Obara"
	WIND CLOCK name="Dall"
	HAZE name="Madga"
	SKIN name="Goch"
	SHIN name="Dara"
	TORTURE name="Sakorwa"
	TOOL name="Sane"
	SCHOLAR name="Orallou"
	WEEP name="Dirwa"
	MASSIVE name="Phaposa"
	LARGE name="Stren"
	SMALL name="Kurai"
	LOAF name="Las"
	TILE name="Virir"
	SPORT name="Larot"
	SEARCH name="Sonosa"
	STALE name="Rerwa"
	FRESH name="Jura"
	RUB name="Gung"
	WORTHY name="Somake"
	WORTHLESS name="Meedgowla"
	FRIGHT name="Grawla"
	REVOLTING name="Morurawla"
	DISGUST name="Darewla"
	OUTRAGE name="Serwara"
	CRUEL name="Lega"
	DEVIANT name="Jarorwa"
	DEVIOUS name="Rirawla"
	FABULOUS name="Siranda"
	MORALITY name="Goragaka"
	IMMORALITY name="Lellesara"
	SKIN VERB name="Rari"
	SKINNY name="Paros"
	NARROW name="Vebopo"
	GRIEF name="Vumm"
	BELT name="Phes"
	SANDAL name="Didara"
	FUTURE name="Jumiem"
	PAST name="Jara"
	PRESENT name="Kadami"
	BITE name="Odusa"
	SPLIT name="Lorwa"
	BRASH name="Moche"
	BRAZEN name="Sereba"
	STRANGLE name="Ranally"
	GALLOWS name="Gakasi"
	MUSCLE name="Kovaga"
	DIM name="Lirwa"
	SPURT name="Chori"
	GRAVEL name="Vanou"
	RISK name="Surwa"
	CHANCE name="Laraka"
	CHANNEL name="Phoreo"
	MIRTH name="Kusav"
	GLEE name="Kusai"
	VICTIM name="Grorai"
	STRANGER name="Khereena"
	DRAB name="Eadao"
	VISION name="Limara"
	VISIONARY name="Kirullou"
	ORACLE name="Kallou"
	UTTER name="Huka"
	DECIDE name="Rasivi"
	DECISIVE name="Phachuma"
	SPECIAL name="Phapana"
	AUTHOR name="Orall"
	AUTHORITY name="Luchaepar"
	PORTENT name="Kanora"
	MOMENTOUS name="Kasallura"
	INFALLIBLE name="Gonebida"
	AMBIGUOUS name="Fleruvech"
	CURIOUS name="Kaeroga"
	OBSCURE name="Jabanao"
	OBSCENE name="Kadorwa"
	OBSTACLE name="Kadges"
	VULGAR name="Larwa"
	OMINOUS name="Didawla"
	ISLAND name="Misung"
	CHURCH name="Phros"
	TEMPLE name="Gorupi"
	CULT name="Oguna"
	COVEN name="Kavus"
	SECT name="Chuch"
	ORDER GROUP name="Phamo"
	CREED name="Vane"
	COMMUNION name="Dallanya"
	DOCTRINE name="Phamama"
	FAITH name="Gorem"
	DENOMINATION name="Phamakorepape"
	TEMPLE HEAD name="Samere"
	OCCULT name="Kavano"
	ORDER CONCEPT name="Vadem"
	FAITH LOYALTY name="Chane"
	GUILT name="Vura"
	BABY name="Salla"
	BLEED name="Verwa"
	GIRL name="Jalla"
	BOY name="Palla"
	WOMAN name="Hosen"
	FLAG name="Ragar"
	BANNER name="Kusapa"
	WREATH name="Kusall"
	STANDARD FLAG name="Serwogar"
	TRUMPET name="Gemull"
	GOAL name="Vell"
	JAIL name="Gres"
	PRISON name="Makes"
	LIBRARY name="Vallou"
	AVALANCHE name="Ranosanou"
	STIGMA name="Chewla"
	SLICK name="Oron"
	TALK name="Hoch"
	JAILER name="Vares"
	STILL UNMOVING name="Khada"
	CALM name="Marao"
	HUSH name="Hara"
	LACONIC name="Koronda"
	LULL name="Srira"
	MUTE name="Sage"
	NOISELESS name="Dunellou"
	QUIESCENT name="Marabung"
	QUIET name="Kera"
	RETICENT name="Phomonda"
	SATURNINE name="Jararunda"
	SPEECHLESS name="Virollou"
	TACITURN name="Ripinda"
	FORTUNE LUCK name="Savarwa"
	FORTUNE WEALTH name="Serorus"
	ACCIDENT name="Chokurwa"
	CIRCUMSTANCE name="Phieriestorwa"
	CONTINGENT name="Phabupus"
	CONTINGENCY name="Manyurworwa"
	COINCIDENCE name="Sukanyirwa"
	FLUKE name="Kerwa"
	LUCK name="Herwa"
	CERTAIN name="Phapasa"
	UNCERTAIN name="Gorererwa"
	FORTUITOUS name="Hamidorwa"
	INCIDENTAL name="Sowlurerwa"
	AMUSE name="Lalle"
	PASTIME name="Lararan"
	DISTRACT ANNOY name="Kodgarwa"
	DISTRACTION GAME name="Laremacha"
	DIVERSION GAME name="Larawlat"
	DIVERT DETOUR name="Jallo"
	RECREATION GAME name="Larorwade"
	COMPETE name="Laropo"
	CONTEST name="Larisao"
	MATCH CONTEST name="Ladga"
	MATCH EQUAL name="Pusar"
	TOURNAMENT name="Larirosong"
	PLAN name="Larav"
	SCENARIO name="Larorull"
	STRATEGY name="Laruvamm"
	TACTIC name="Laride"
	AUTONOMY name="Srollaro"
	EMANCIPATE name="Masadaburo"
	EXTRICATE name="Phodamoro"
	IMPUNITY name="Kagero"
	LIBERATE name="Rurumoro"
	LIBERTY name="Gollaro"
	RELEASE name="Phasoro"
	RELIEVE name="Rerworo"
	EVEN name="Earor"
	BALANCE name="Earanot"
	EQUITY name="Earosa"
	EQUIVALENCE name="Earineronye"
	PARITY name="Earisa"
	STASIS name="Earabe"
	SYMMETRY name="Darode"
	EQUAL name="Earom"
	HARMONY name="Earunan"
	NEUTRALIZE name="Earanderav"
	NEUTRAL name="Earanan"
	STABLE UNCHANGING name="Konade"
	LULL MISLEAD name="Rasun"
	DOUR name="Gos"
	GLOOM name="Hoda"
	SEVERE name="Rasech"
	GLUM name="Vake"
	IMAGE name="Vasum"
	SHRINE name="Veros"
	SANCTUARY name="Wrynuvos"
	MONASTERY name="Gosururwa"
	CONVENT name="Gorerus"
	CATHEDRAL name="Gorallang"
	CHAPEL name="Oguvos"
	SANCTUM name="Gorudes"
	INFERNO name="Hurou"
	CONFLAGRATION name="Vedgerarou"
	FLARE name="Dirou"
	HEAT name="Ginda"
	SAND name="Kome"
	PILLAR name="Hobura"
	COLUMN name="Parona"
	ARCH NOUN name="Ovull"
	GROTTO name="Gosake"
	CAVERN name="Kunuda"
	DEPTH name="Lada"
	SHADE name="Jasta"
	VEIL name="Java"
	RELIC name="Vudga"
	UMBRA name="Gesta"
	PHANTOM name="Kovusi"
	MURK name="Gada"
	FAINT INTENSITY name="Kasta"
	FAINT VERB name="Chera"
	SOMBER name="Dastou"
	TENEBROUS name="Jabastare"
	MOROSE name="Karou"
	LOVER name="Mora"
	BELOVED name="Sasinda"
	ESCORT name="Sonike"
	SUITOR name="Mosene"
	PUNGENT name="Geranda"
	MUSTY name="Phen"
	INFECT name="Srasas"
	LESION name="Flawla"
	AFFLICT name="Hiewla"
	ACHE name="Flura"
	EPIDEMIC name="Lerawla"
	FIGHT name="Ramao"
	SCUFFLE name="Raran"
	YAWN name="Kose"
	ACTION name="Phapat"
	ASSAULT name="Ranopa"
	CARNAL name="Monova"
	STRIFE name="Ranasa"
	COMBAT name="Raneme"
	CITADEL name="Kaneram"
	CITY name="Kong"
	TOWN name="Flaen"
	VILLAGE name="Gestull"
	MANOR name="Garom"
	MANSION name="Orunull"
	PALACE name="Hunull"
	COTTAGE name="Rullull"
	SHACK name="Reng"
	HUT name="Darai"
	HOVEL name="Vurai"
	BASTION name="Phucham"
	FURNACE name="Mirarou"
	ANVIL name="Hobur"
	BRIDGE name="Rovull"
	SAFE name="Sonem"
	GOAD name="Jadga"
	MACHINE name="Kosull"
	FLAY name="Ranar"
	OIL name="Gonou"
	SUICIDE name="Sesasi"
	MARBLE BALL name="Vomull"
	BAIT name="Mengh"
	LURE name="Danat"
	REWARD name="Gonera"
	WARD name="Sonam"
	PRICE name="Sagas"
	PRINCE name="Rorar"
	PRINCESS name="Guragar"
	TEMPT name="Kega"
	SPURN name="Hirwa"
	SCORN name="Vang"
	CONTEMPT name="Chugorwa"
	AFFECTION name="Mosakoget"
	COMPASSION name="Somarawla"
	SACRIFICE name="Somasaesa"
	CHARITY name="Sosan"
	CHERISH name="Hanunda"
	TRAMPLE name="Grana"
	MALICE name="Gogara"
	HATRED name="Lellos"
	SPITE name="Karus"
	SHORE name="Greda"
	BEACH name="Madav"
	COAST name="Made"
	INSECT name="Goseva"
	BUG name="Goda"
	CRITTER name="Gosinye"
	BRUTE name="Phusa"
	PET name="Kiere"
	BARBARIAN name="Kugullosa"
	HARSH name="Ruda"
	PRISTINE name="Gosobere"
	FEROCITY name="Serera"
	BARBARITY name="Lunobasa"
	FERAL name="Susa"
	FURY name="Sedun"
	RUTHLESS name="Lellarev"
	GORE NOUN name="Rave"
	CHAMPION name="Phapaega"
	VIRTUE name="Somav"
	SCANDAL name="Jasawla"
	APOGEE name="Phapin"
	SPIRE name="Pave"
	SPIRAL name="Gradga"
	CLIMAX name="Phadas"
	CLIMATE name="Mirolle"
	WEATHER name="Gosomon"
	CREST name="Grach"
	CULMINATE name="Phapipav"
	CUSP name="Rav"
	MOST name="Ronar"
	PEAK name="Hobe"
	BLUNT name="Flam"
	ROOF name="Ogull"
	CEILING name="Rarull"
	FLOOR name="Sare"
	SUMMIT name="Hobova"
	TIP name="Mundo"
	TOP name="Sago"
	BOTTOM name="Rurai"
	SIDE name="Ealla"
	ZENITH name="Hobera"
	FLANK VERB name="Khude"
	PASS MOUNTAIN name="Goros"
	PASS VERB name="Haet"
	PASSAGE name="Dondara"
	CORRIDOR name="Ranuraga"
	HALL name="Dosta"
	GALLERY name="Kadarou"
	GALLEY name="Divull"
	ARENA name="Debar"
	ARMORY name="Hanull"
	ASSEMBLE name="Kusodo"
	MEET name="Kuson"
	THEATER name="Kunom"
	ENTRANCE name="Chirieka"
	EXIT name="Oda"
	ENTRY name="Volly"
	VESTIBULE name="Rochedull"
	FROST name="Choma"
	FEVER name="Hirai"
	HUMID name="Mama"
	HUMOR name="Pheda"
	COMEDY name="Kusuga"
	SIZZLE name="Daerou"
	SWELTER name="Orwarou"
	WARM name="Dorou"
	TORRID name="Phurou"
	ACRID name="Voba"
	DALE name="Goram"
	DELL name="Gogeo"
	GLADE name="Gono"
	VALE name="Gone"
	BASIN name="Gosum"
	BOWL name="Phora"
	CAVITY name="Phura"
	CRATER name="Sasoro"
	DEN name="Wryna"
	DENT name="Rat"
	DEPRESS SAD name="Marawla"
	DEPRESSION LOW name="Supavabana"
	DIMPLE name="Eamure"
	DIP name="Jena"
	DISH name="Meng"
	EXCAVATE name="Rararan"
	GROOVE name="Korape"
	GULF SEA name="Grero"
	GULF PIT name="Gana"
	GULF DISTANCE name="Kano"
	DISTANCE name="Laganamm"
	NOTCH name="Dage"
	SAG name="Gaena"
	SCOOP name="Phadi"
	SOCKET name="Chere"
	TROUGH name="Fleera"
	VALLEY name="Gosode"
	FENCE name="Olles"
	BARRICADE name="Sonabani"
	BLOCKADE name="Maranyes"
	BOARD PLANK name="Kies"
	BOARD GET ON name="Huneo"
	PLANK name="Luran"
	DEFEND name="Sonov"
	DEFENSE name="Saballa"
	DIKE name="Sos"
	PALISADE name="Danarull"
	POST name="Omull"
	RAMPART name="Sonusa"
	STAKE name="Sanai"
	STOP name="Raeva"
	STOCKADE name="Vorunull"
	ABYSS name="Onada"
	CHASM name="Hangh"
	CREVICE name="Mereda"
	RIFT name="Visan"
	FISSURE name="Gullach"
	UNDER name="Sasta"
	ABYSMAL name="Srewla"
	SUBMERGE name="Gullane"
	CYCLONE name="Govumm"
	TYPHOON name="Rallara"
	HURRICANE name="Kamarwara"
	GALE name="Molly"
	TORNADO name="Ranugan"
	HAIL GREET name="Gecha"
	HAIL ICE name="Gollo"
	HALE name="Vaka"
	ROBUST name="Phabov"
	HARDY name="Phamm"
	VIGOR name="Phaga"
	AIR name="Omm"
	SPLASH name="Gullar"
	DABBLE name="Horana"
	DOUSE name="Rurwa"
	DRENCH name="Rierwa"
	MOIST name="Gura"
	PLUNGE name="Mekao"
	SHOWER name="Sinyis"
	SLOP name="Veena"
	SLOSH name="Gurar"
	SOAK name="Gucha"
	SPATTER name="Sarira"
	SPLATTER name="Ranesa"
	SPRAY name="Gunya"
	SPREAD name="Rinull"
	SPRINKLE name="Lorwomm"
	TWINKLE name="Chowlan"
	SQUIRT name="Gralla"
	WAD name="Geda"
	WADE name="Phret"
	WET name="Malla"
	FADE name="Susta"
	COLORLESS name="Onarwade"
	BLANCH name="Osorwa"
	BLEACH name="Chorwa"
	BLENCH name="Jarwa"
	FLINCH name="Cherai"
	APPEAR name="Phurai"
	DISAPPEAR name="Konerwa"
	DISSOLVE name="Hoderwa"
	DULL name="Suri"
	EVAPORATE name="Ruronarwa"
	LUSTER name="Chokes"
	TONE name="Keveo"
	VANISH name="Kherwa"
	WASH name="Gurao"
	ABATE name="Murwa"
	DECLINE name="Sararwa"
	DETERIORATE name="Orarusarwa"
	DIMINISH name="Khorarwa"
	DISPERSE name="Vumirwa"
	DROOP name="Opona"
	DWINDLE name="Jadirwa"
	KINDLE name="Phiste"
	STOKE name="Pheva"
	POKE name="Phave"
	STIR name="Lapeo"
	FEED name="Jeo"
	FAIL name="Govov"
	LANGUISH name="Easanda"
	LESSEN name="Oparwa"
	LESSON name="Hollou"
	TEACH name="Kapam"
	MASTERY name="Onarar"
	PERISH name="Kobisi"
	SHRIVEL name="Gidawla"
	SINK name="Kopa"
	TAPER name="Rella"
	THIN name="Kebuv"
	TIRE name="Gon"
	WANE name="Kase"
	WEAK name="Kado"
	WILT name="Muna"
	WITHER name="Rigasi"
	HONOR name="Somam"
	ADORE name="Renda"
	ADULATE name="Phopude"
	CELEBRATE name="Kusellara"
	CONFIDENT name="Phapabara"
	DEFERENCE name="Doduperai"
	DEITY name="Gera"
	DISTINCT name="Phadan"
	ELEVATE name="Hunaga"
	ESTEEM name="Phapos"
	EXALT name="Keda"
	FAME name="Kar"
	FEALTY name="Phruv"
	HOMAGE name="Madgut"
	MORTAL name="Gorena"
	IMMORTAL name="Vorolliv"
	LAUD name="Srach"
	OBEISANCE name="Karasara"
	PRAISE name="Muras"
	PRESTIGE name="Phaparon"
	RENOWN name="Kavung"
	REPUTATION name="Grarogowla"
	TRIBUTE name="Miera"
	WORSHIP name="Kallosa"
	CHASTITY name="Gorieso"
	COURAGE name="Phavara"
	DECENT name="Duren"
	GOOD name="Somur"
	INNOCENT name="Janokong"
	MODEST name="Manya"
	PRINCIPLE name="Sallurech"
	PURE name="Somat"
	RIGHTEOUSNESS name="Goradgawle"
	TRUTH name="Somao"
	TRUTHFUL name="Radech"
	VIRGIN name="Pekona"
	VIRGINITY name="Flonadi"
	HOLD name="Koges"
	SCALD name="Ranes"
	SCALE VERB name="Pall"
	SCALE SKIN name="Gorut"
	CLAN name="Dalla"
	LABYRINTH name="Jaborosa"
	MAZE name="Japus"
	WEB name="Jabai"
	CROWD name="Mana"
	FAMILY name="Phrun"
	KIN name="Volla"
	MOB name="Rabis"
	ORGAN name="Greka"
	ORGANIZE name="Karodade"
	MESH name="Phor"
	TANGLE name="Hunyes"
	ENTANGLE name="Flares"
	PUZZLE name="Jabosa"
	PERPLEX name="Jabawla"
	QUANDARY name="Jabedana"
	COMBINE name="Kapara"
	FLICKER name="Korarou"
	BRAND name="Morou"
	SINGE name="Gurou"
	SEAR name="Jarou"
	SCORCH name="Harou"
	ROAST name="Vorou"
	PARCH name="Vurou"
	IGNITE name="Ranosi"
	INCINERATE name="Ranadekesa"
	GLOW name="Orou"
	CREMATE name="Kodasi"
	FACTION name="Kaedga"
	CREW name="Musta"
	VESSEL name="Moras"
	LEAGUE GROUP name="Pharat"
	COOPERATE name="Jandarare"
	GROUP name="Perar"
	GANG name="Rare"
	FELLOWSHIP name="Phamadgit"
	PARTNER name="Struna"
	RIDDLE name="Jabube"
	ROUT name="Ranut"
	SCRAPE name="Ranura"
	SCRAP name="Kirai"
	SCOUR name="Huna"
	SCRUB name="Vaell"
	SHAKE name="Kuch"
	SOAP name="Danin"
	SPONGE name="Rerema"
	SWEEP name="Phako"
	WHISKER name="Gosusas"
	FASTEN name="Grareo"
	WINNOW name="Pherwa"
	WIPE name="Vadai"
	CLENCH name="Kanyes"
	CLINCH name="Chiena"
	CLOUT name="Ranor"
	CLUTCH name="Vores"
	DOMINATE name="Phapodas"
	DOMINION name="Hanyasar"
	GRASP name="Rases"
	INFLUENCE name="Phaperora"
	OWN name="Vuva"
	OWNERSHIP name="Mandarov"
	TENACITY name="Phrarwis"
	BIND name="Mes"
	CARRY name="Srora"
	CATCH name="Kuba"
	CONFINE name="Eagares"
	CONTAIN name="Jaraves"
	CRADLE name="Sonoba"
	EMBRACE name="Mosacha"
	POOL name="Sus"
	SOCIETY name="Pharosa"
	CIRCLE name="Rolly"
	SQUARE name="Garade"
	TRIANGLE name="Medara"
	CONNECT name="Chakon"
	MERGE name="Jede"
	CONFUSE name="Jaronan"
	COMPLEX name="Jowluna"
	MEANDER name="Gekunda"
	MUDDLE name="Jaboga"
	BEWILDER name="Jabavona"
	MORASS name="Pirasa"
	PROBLEM name="Sagit"
	INTRICATE name="Poruranda"
	FLUSH name="Phoge"
	MOP name="Orara"
	POLISH name="Damape"
	PURGE name="Sirwa"
	RASP name="Lori"
	RINSE name="Mall"
	BAND OBJECT name="Orosa"
	BAND GROUP name="Jade"
	TALL name="Paseo"
	SHORT name="Phra"
	BULBOUS name="Higora"
	BULB name="Goka"
	ALLY name="Dao"
	ALLIANCE name="Hurach"
	ALLEGIANCE name="Maerorwan"
	COALITION name="Pharoras"
	COAL name="Sonou"
	ENJOY name="Kusan"
	FONDLE name="Kapum"
	HANDLE OBJECT name="Merull"
	HANDLE VERB name="Grape"
	IMPRISON name="Obolles"
	NOURISH name="Sovada"
	SQUEEZE name="Rarar"
	TRAMMEL name="Galles"
	VICE name="Ledes"
	VISE name="Lores"
	DEFECT FAULT name="Phowla"
	PERFECT name="Phapone"
	GEM name="Kanou"
	JEWEL name="Molla"
	WIELD name="Poche"
	WRING name="Henam"
	CONJUNCTION name="Raseramm"
	BLOT name="Kupeo"
	BLOW name="Chot"
	BRUSH name="Mongh"
	CLARIFY name="Herera"
	CLEANSE name="Marurwa"
	DREDGE name="Reewla"
	ERASE name="Huras"
	MORSEL name="Ororai"
	MONGREL name="Kesosa"
	TENDER name="Mosuch"
	URGE name="Chech"
	MECHANISM name="Sonunull"
	SMEAR name="Dawli"
	TATTOO name="Hedgum"
	WEATHER VERB name="Gorarwa"
	CRUX name="Mis"
	PEEK name="Omemm"
	SNEAK name="Jama"
	ATTIC name="Govou"
	BASEMENT name="Darunull"
	DEARTH name="Dodou"
	APEX name="Var"
	NADIR name="Hilly"
	TUNNEL name="Dondin"
	ENTRANCE VERB name="Hanulla"
	DELIGHT name="Kusang"
	JOY name="Kusou"
	FRIGID name="Keenda"
	ANKLE name="Eamon"
	ELBOW name="Mega"
	PASSION name="Mopumm"
	ARDENT name="Ranana"
	STREAM name="Gosall"
	BOWEL GUT name="Vera"
	BOWEL INTERIOR name="Done"
	DRILL BORE name="Ranin"
	DRILL ROUTINE name="Marwe"
	BORE DRILL name="Kove"
	BOREDOM name="Gaduwla"
	FLECK name="Morai"
	SPOT name="Chao"
	DOT name="Radeo"
	CREATE name="Vasull"
	POEM name="Hidga"
	POETRY name="Vollou"
	POET name="Henda"
	SCRIBE name="Millou"
	MONK name="Gorar"
	HERMIT name="Kapov"
	RECLUSE name="Radet"
	NAME name="Rima"
	LANGUAGE name="Deedull"
	PHRASE name="Javeo"
	RHYME name="Gaveo"
	RHYTHM name="Grari"
	VERSE name="Vaveo"
	DRUM VERB name="Saveo"
	CREATURE name="Gosadga"
	SNAIL name="Dirai"
	VINE name="Gopam"
	SQUASH name="Ranomm"
	NEVER name="Perwa"
	DWELL name="Chare"
	HABIT name="Vare"
	CHEW name="Phe"
	SWALLOW name="Pharweo"
	DISEMBOWEL name="Ravallepa"
	EVISCERATE name="Ranorollav"
	RAPID name="Odisa"
	MEDICINE name="Sonerori"
	HEAL name="Sodga"
	SELL name="Samm"
	MARKET name="Sagidi"
	SLOW name="Kirwa"
	MIRE name="Pirot"
	ADMIRE name="Phaeda"
	DIRGE name="Sresi"
	LAMENT name="Meewla"
	FUNERAL name="Radasi"
	QUEST name="Onem"
	ADVENTURE name="Phapuran"
	MOURN name="Rach"
	MORNING name="Gosaba"
	BULWARK name="Koden"
	COSMOS name="Padara"
	ANGUISH name="Gistara"
	TAUT name="Redga"
	DEIFY name="Govav"
	INFAMY name="Haera"
	MORTALITY name="Kadallaba"
	IMMORTALITY name="Gorurulla"
	MORTIFY name="Musara"
	OBEY name="Jolla"
	WORSHIPPER name="Gororumov"
	RIDDLE HOLES name="Raneno"
	DWELLING name="Phorelle"
	DISEMBOWELMENT name="Ranillanestemao"
	EVISCERATION name="Ranadgebanupa"
	HEALING name="Sonora"
	ADMIRATION name="Keereenom"
	CONFLICT name="Ranonada"
	ATTACK name="Raniba"
	ONSLAUGHT name="Fladganya"
	TREE name="Pheba"
	AMBER name="Kode"
	AMETHYST name="Seranda"
	AQUA name="Kodi"
	AQUAMARINE name="Phanasunda"
	GRAY name="Kom"
	AUBURN name="Kochun"
	AZURE name="Panda"
	BEIGE name="Monda"
	BRASS name="Koros"
	BROWN name="Kores"
	BUFF name="Kov"
	SIENNA name="Gonda"
	UMBER name="Lenou"
	CARDINAL_COLOR name="Koduna"
	CARMINE name="Kochase"
	CERULEAN name="Doronda"
	CHARCOAL name="Kosora"
	CHARTREUSE name="Kochiraka"
	CHESTNUT name="Gosolly"
	CHOCOLATE name="Kallasona"
	CINNAMON name="Gosonida"
	COBALT name="Phures"
	INDIGO name="Kochot"
	OLIVE name="Serao"
	PINK name="Koch"
	SCARLET name="Kochera"
	TAN name="Phiv"
	ECRU name="Kos"
	EMERALD name="Kochuda"
	FLAX name="Mone"
	FUCHSIA name="Kochosa"
	GOLDENROD name="Gosenorut"
	HELIOTROPE name="Kapobunda"
	LAVENDER name="Vichanda"
	BLUSH name="Mosou"
	LEMON name="Kosam"
	LILAC name="Kolle"
	LIME name="Gores"
	MAHOGANY name="Gosusina"
	MAROON_COLOR name="Konya"
	MAUVE name="Lunda"
	TAUPE name="Menda"
	MINT name="Korom"
	MOSS name="Kochi"
	OCHRE name="Ginou"
	ORANGE name="Kasim"
	PERIWINKLE name="Ganellanda"
	PLUM name="Kora"
	PUCE name="Koban"
	PUMPKIN name="Kochura"
	RUSSET name="Kochar"
	SAFFRON name="Gosuro"
	SEPIA name="Kosao"
	TEAL name="Goste"
	TURQUOISE name="Syhavanou"
	VERMILION name="Kasunda"
	PATH name="Onduv"
	THREAT name="Phapen"
	WARNING name="Gasuwla"
	FATE name="Dosi"
	DESTINY name="Onara"
	HORROR name="Flowla"
	LITTLE name="Mierai"
	EARLY name="Jumm"
	LATE name="Kunya"
	LIFE name="Vona"
	CHEESE name="Sralla"
	FIGURE_OBJECT name="Kasull"
	HOPE name="Somas"
	BODY name="Mera"
	WALK name="Khesa"
	HOUR name="Jasam"
	SIT name="Chura"
	MOMENT name="Flare"
	BEAUTY name="Mosake"
	JUDGE name="Phode"
	WISH name="Gare"
	RESPECT name="Gomiras"
	MARK name="Eara"
	HEAVY name="Roka"
	TRIAL name="Piwla"
	PRACTICE name="Jorwolly"

FLOWERY = -Unda
NATURE = Gos-
PRIMITIVE = -Asa
HOLY = Gor-
EVIL = Lell-
NEGATOR = -Orwa
MAGIC = Kav-
VIOLENT = Ran-
PEACE = Mar-
UGLY = Sras-
DEATH = -Asi
OLD = Grir-
SUBORDINATE = -Erai
LEADER = -Gar
NEW = Jund-
DOMESTIC = Phadg-
MYTHIC = -Ara
ARTIFICE = -Null
COLOR = Koch-
MYSTERY = Jab-
NEGATIVE = -Awla
ROMANTIC = Mos-
ASSERTIVE = Phap-
AQUATIC = Gull-
PROTECT = Son-
RESTRAIN = -Nyes
THOUGHT = -Allou
WILD = Serw-
NAME_SWAMP = Pir-
NAME_DESERT = -Ras
NAME_FOREST = -Sar
NAME_MOUNTAINS = Mon-
NAME_OCEAN = Grer-
NAME_GLACIER = Rar-
NAME_TUNDRA = -Oma
NAME_GRASSLAND = -Iesa
NAME_HILLS = -Aba
NAME_REGION = Var-
NAME_CAVE = -Ada
EARTH = -Onou
NAME_LAKE = Jar-
NAME_ENTITY_KINGDOM = -Daem
NAME_ENTITY_TOWN_FOUNDER = Phar-
GOOD = Som-
NAME_CONTINENT = Mor-
NAME_ISLAND = -Anao
NAME_ISLAND_SMALL = -Rwung
NAME_PEAK = Hob-
NAME_VOLCANO = -Ros
NAME_COMMON_RELIGION = Pham-
BALANCE = Earie-
BOUNDARY = Mad-
DANCE = Grar-
DARKNESS = -Esta
LIGHT = Chowl-
ORDER = -Ode
FESTIVAL = Kus-
FAMILY = -Alla
FIRE = -Arou
FOOD = Kall-
FREEDOM = -Oro
GAMES = Lar-
LUCK = -Erwa
MUSIC = -Aveo
SKY = Sen-
SILENCE = -Illou
TRADE = Sag-
TRAVEL = Kher-
TRUTH = -Dech
WEALTH = Ser-
NAME_BUILDING_TEMPLE = -Vos
NAME_BUILDING_KEEP = -Vam
NAME_WAR = -Owla
NAME_BATTLE = -Apa
NAME_SIEGE = Fladg-
NAME_ROAD = Ondo-
NAME_TUNNEL = Dond-
NAME_BRIDGE = Rany-
NAME_WALL = Kov-
NAME_BUILDING_TOMB = Vas-
71073 Rejected Words
Intended Word Length 0.87 Times Longer Than Normal
Forced Maximum Word Length 0 Letters Longer Than Normal
